FIPS,MSA,TOT_POP,POP_16,POP_65,WHITE_,BLACK_,ASIAN_,HISP_,MULTI_RA,MALES,FEMALES,MALE1664,FEM1664,EMPL16,EMP_AWAY,EMP_HOME,EMP_29,EMP_30,EMP16_2,EMP_MALE,EMP_FEM,OCC_MAN,OCC_OFF1,OCC_INFO,HH_INC,POV_POP,POV_TOT,HSG_VAL,FIPSNO,POLYID
06061022001,Sacramento,5501,1077,518,4961,29,82,336,31,2982,2519,2115,1791,2889,2606,283,1573,1033,2972,1785,1187,117,663,42,52941,5461,470,225900,6061022001,1
06061020106,Sacramento,2072,396,109,1603,0,28,391,41,1065,1007,839,728,1151,1067,84,908,159,1175,653,522,38,229,19,51958,2052,160,249300,6061020106,2
06061020107,Sacramento,3633,911,126,1624,9,0,1918,41,1970,1663,1459,1137,1791,1692,99,1354,338,1857,1159,698,86,197,0,32992,3604,668,175900,6061020107,3
06061020105,Sacramento,1683,281,154,1564,0,55,60,4,820,863,606,642,1013,954,59,789,165,1026,507,519,5,256,6,54556,1683,116,302300,6061020105,4
06061020200,Sacramento,5794,1278,830,5185,17,13,251,229,2913,2881,1861,1825,2633,2423,210,739,1684,2730,1470,1260,155,506,59,50815,5771,342,167300,6061020200,5
06061020101,Sacramento,755,90,53,698,0,19,33,5,420,335,348,264,405,377,28,325,52,424,296,128,11,111,9,60167,755,63,247800,6061020101,6
06061020104,Sacramento,1817,244,280,1771,25,16,0,0,970,847,701,592,856,754,102,653,101,941,556,385,42,101,5,49063,1775,203,394000,6061020104,7
06061020103,Sacramento,1096,155,66,1064,0,9,13,6,639,457,501,374,766,738,28,673,65,777,458,319,4,153,8,52171,1096,56,311600,6061020103,8
06061020102,Sacramento,1102,195,62,1034,0,0,20,39,563,539,456,389,704,622,82,564,58,721,412,309,10,193,31,62500,1102,50,376000,6061020102,9
06061022002,Sacramento,5297,1175,729,4805,4,18,298,126,2612,2685,1680,1713,2543,2394,149,1318,1076,2601,1425,1176,129,589,73,46747,5249,370,194000,6061022002,10
06017030503,Sacramento,1184,220,106,1117,4,0,0,53,631,553,469,389,665,583,82,450,133,681,398,283,0,200,15,51333,1184,90,232800,6017030503,11
06061021901,Sacramento,3074,596,454,2760,0,55,172,75,1538,1536,1028,996,1565,1514,51,931,583,1603,865,738,74,307,5,55000,3008,206,206500,6061021901,12
06061021304,Sacramento,4727,1022,584,3972,0,72,477,143,2423,2304,1608,1513,2232,1976,256,807,1169,2278,1268,1010,116,424,57,52286,4692,328,235900,6061021304,13
06061021902,Sacramento,4305,967,675,3865,0,21,184,134,2183,2122,1308,1355,2046,1883,163,1076,807,2074,1149,925,74,535,84,59443,4286,130,225400,6061021902,14
06061021600,Sacramento,7347,1439,1432,6260,0,291,585,137,3494,3853,2250,2226,2942,2770,172,1851,919,3051,1640,1411,192,659,30,38854,6866,673,228600,6061021600,15
06017030603,Sacramento,2776,577,349,2577,0,7,130,54,1345,1431,877,973,1186,1123,63,443,680,1231,637,594,49,254,31,41982,2759,229,157500,6017030603,16
06061021801,Sacramento,4032,822,556,3700,20,33,140,109,2040,1992,1361,1293,1722,1562,160,860,702,1787,980,807,86,439,44,67300,4026,147,245900,6061021801,17
06017030602,Sacramento,5786,1224,778,5204,55,27,285,158,2993,2793,1970,1814,2362,2218,144,774,1444,2434,1263,1171,50,490,39,47672,5716,454,161200,6017030602,18
06061021301,Sacramento,2747,674,273,2295,37,0,299,101,1402,1345,943,857,1292,1189,103,632,557,1333,757,576,77,287,40,56432,2747,167,172800,6061021301,19
06017030200,Sacramento,5072,1283,393,2541,39,316,2102,54,2638,2434,1841,1555,2304,2198,106,1883,315,2400,1318,1082,72,342,21,33560,4975,802,144700,6017030200,20
06017030101,Sacramento,283,30,22,150,0,33,96,0,162,121,139,92,150,95,55,75,20,150,87,63,0,48,0,28750,283,61,123500,6017030101,21
06017030102,Sacramento,4088,1023,269,1511,27,701,1794,49,2220,1868,1558,1238,1912,1869,43,1663,206,1979,1146,833,55,216,41,32045,4076,547,175700,6017030102,22
06061021501,Sacramento,4360,857,776,3762,4,72,369,128,2141,2219,1389,1338,1866,1767,99,1183,584,1905,1003,902,113,368,67,45426,4222,302,189700,6061021501,23
06017030300,Sacramento,5805,1283,425,4121,0,159,1280,163,2873,2932,2082,2015,2958,2858,100,2520,338,3012,1517,1495,98,367,0,32492,5740,711,148700,6017030300,24
06017030401,Sacramento,4260,793,569,3569,8,86,440,149,2075,2185,1440,1458,2203,2069,134,1777,292,2284,1223,1061,85,381,13,51092,4242,207,189300,6017030401,25
06017030501,Sacramento,6174,1389,521,5567,102,73,276,120,3196,2978,2187,2077,3209,2986,223,2608,378,3269,1756,1513,87,679,74,56528,6174,252,193300,6017030501,26
06017030601,Sacramento,4607,1015,611,4162,13,14,231,125,2338,2269,1475,1506,2151,2005,146,715,1290,2193,1149,1044,135,577,28,61505,4601,114,212200,6017030601,27
06061021502,Sacramento,3632,788,536,3323,6,50,199,20,1721,1911,1098,1210,1820,1695,125,1209,486,1817,963,854,74,423,44,54412,3611,217,195900,6061021502,28
06061021802,Sacramento,5999,1196,1475,5369,6,79,369,96,2765,3234,1552,1776,2451,2310,141,1590,720,2473,1205,1268,136,468,63,48729,5791,400,176500,6061021802,29
06017030502,Sacramento,3047,624,244,2805,0,40,125,70,1578,1469,1115,1064,1795,1707,88,1463,244,1835,924,911,31,363,29,50948,3047,151,165100,6017030502,30
06113011500,Sacramento,4552,1257,534,2438,41,99,1848,92,2357,2195,1467,1294,1758,1629,129,944,685,1813,1024,789,63,229,5,40577,4485,569,148100,6113011500,31
06113011400,Sacramento,3784,944,480,1780,203,4,1717,62,1935,1849,1250,1110,1518,1420,98,921,499,1565,861,704,45,166,4,36202,3784,565,125800,6113011400,32
06061020500,Sacramento,5934,1222,1060,5374,11,104,214,166,2885,3049,1769,1883,2746,2566,180,1543,1023,2789,1523,1266,140,788,80,65118,5924,215,265800,6061020500,33
06017030402,Sacramento,4155,904,379,3320,25,120,583,30,2010,2145,1428,1444,2028,1926,102,1679,247,2082,1000,1082,96,345,50,32574,4153,633,117100,6017030402,34
06061020400,Sacramento,5657,1136,925,4998,10,96,370,146,2690,2967,1743,1853,2698,2513,185,1708,805,2782,1460,1322,102,755,84,49789,5642,326,213800,6061020400,35
06061021401,Sacramento,2281,552,295,1531,0,26,640,62,1161,1120,744,690,1004,978,26,561,417,1052,633,419,144,164,57,41010,2273,207,127900,6061021401,36
06061021402,Sacramento,6960,1983,688,4560,60,69,2066,134,3382,3578,2123,2166,2986,2891,95,1754,1137,3027,1605,1422,298,464,27,40995,6801,1073,132800,6061021402,37
06061020300,Sacramento,4711,882,955,4120,31,68,299,150,2154,2557,1395,1479,2168,2123,45,1565,558,2248,1142,1106,83,467,36,37346,4572,502,165400,6061020300,38
06061021200,Sacramento,7881,1889,1042,6773,50,201,529,255,3959,3922,2508,2442,3767,3583,184,2081,1502,3852,2075,1777,135,938,150,57791,7868,303,185200,6061021200,39
06061021303,Sacramento,5693,1743,433,4818,107,148,397,185,2718,2975,1636,1881,2682,2421,261,1247,1174,2699,1466,1233,11,1048,220,87347,5693,25,244500,6061021303,40
06061021104,Sacramento,8152,2156,719,6855,55,376,594,181,4060,4092,2608,2669,3883,3627,256,1940,1687,3914,2209,1705,52,1454,182,85612,8137,117,248500,6061021104,41
06061020602,Sacramento,6147,1285,894,5312,0,295,303,178,3001,3146,1920,2048,2907,2576,331,1624,952,2988,1695,1293,110,944,141,71625,6123,365,309700,6061020602,42
06061020601,Sacramento,6425,1422,796,5822,39,146,296,114,3109,3316,2028,2179,3389,3098,291,1551,1547,3435,1891,1544,74,1255,116,94350,6410,181,353600,6061020601,43
06017031403,Sacramento,97,6,16,86,0,2,3,0,61,36,50,25,58,54,4,34,20,58,44,14,0,15,0,51563,97,0,168800,6017031403,44
06017030901,Sacramento,2726,561,337,2464,0,18,139,105,1336,1390,940,888,1321,1242,79,465,777,1337,718,619,48,389,78,53450,2707,163,242400,6017030901,45
06061021105,Sacramento,5575,1620,211,4564,155,132,568,110,2636,2939,1749,1995,2917,2804,113,1684,1120,2891,1481,1410,80,980,143,70099,5549,342,213000,6061021105,46
06061021103,Sacramento,3690,941,332,3045,0,126,386,86,1770,1920,1148,1269,1888,1845,43,1190,655,1909,931,978,71,357,78,46196,3674,536,141100,6061021103,47
06061021106,Sacramento,2278,415,405,2057,101,20,49,51,1214,1064,797,661,1064,996,68,602,394,1090,637,453,40,308,33,55994,2278,47,195000,6061021106,48
06061021004,Sacramento,3692,1106,165,2861,69,207,325,230,1822,1870,1189,1232,1831,1764,67,903,861,1851,1058,793,49,716,88,78793,3686,85,221100,6061021004,49
06061021109,Sacramento,2969,544,225,2520,16,127,265,41,1573,1396,1185,1015,1664,1566,98,937,629,1660,938,722,81,680,69,80447,2828,20,242800,6061021109,50
06017031302,Sacramento,4644,1044,768,4012,0,38,359,126,2354,2290,1438,1394,1844,1767,77,913,854,1874,1035,839,130,226,9,36810,4629,482,129500,6017031302,51
06017031301,Sacramento,3403,679,596,2994,13,37,231,95,1705,1698,1030,1098,1481,1402,79,945,457,1528,821,707,49,336,38,47500,3403,352,181400,6017031301,52
06061021107,Sacramento,6370,1788,545,5260,55,309,429,233,3004,3366,1861,2176,3198,2953,245,1779,1174,3262,1642,1620,115,876,190,54647,6348,289,172100,6061021107,53
06017031000,Sacramento,5750,1257,974,4841,60,64,659,91,2799,2951,1720,1799,2495,2386,109,1547,839,2520,1296,1224,137,466,112,42363,5640,279,173800,6017031000,54
06061021108,Sacramento,2870,638,518,2429,17,59,218,147,1401,1469,844,870,1313,1235,78,743,492,1324,725,599,75,166,18,33947,2870,228,117800,6061021108,55
06113010102,Sacramento,7256,2162,768,3705,148,346,2486,502,3600,3656,2156,2170,2318,2292,26,1649,643,2362,1284,1078,194,189,46,29277,7180,2038,94300,6113010102,56
06017031100,Sacramento,5084,1065,871,4371,0,30,503,115,2340,2744,1447,1701,2266,2192,74,1436,756,2297,1176,1121,115,421,29,42045,5059,499,157200,6017031100,57
06061021003,Sacramento,4968,1142,512,3968,68,124,673,94,2406,2562,1642,1672,2438,2280,158,1472,808,2515,1372,1143,92,560,111,52083,4951,208,177000,6061021003,58
06017030801,Sacramento,3730,922,370,3297,51,20,188,128,1914,1816,1202,1236,1752,1683,69,717,966,1781,932,849,64,456,42,70984,3724,37,241600,6017030801,59
06061021008,Sacramento,7229,1823,743,5442,129,376,1051,173,3579,3650,2315,2348,3730,3627,103,2055,1572,3805,1994,1811,182,1021,199,53171,7209,313,149400,6061021008,60
06017030701,Sacramento,5442,1637,335,4674,159,189,290,71,2737,2705,1720,1750,2475,2204,271,1087,1117,2587,1582,1005,57,1088,158,99325,5442,91,330500,6017030701,61
06061020704,Sacramento,1873,482,45,1538,19,145,125,39,961,912,683,663,1015,999,16,674,325,1023,578,445,27,386,39,62443,1873,132,205600,6061020704,62
06017031406,Sacramento,5342,1255,774,4799,24,16,284,126,2631,2711,1642,1671,2223,2135,88,823,1312,2243,1238,1005,136,424,12,51635,5265,430,160200,6017031406,63
06061020604,Sacramento,5495,1450,512,4926,61,57,255,190,2702,2793,1736,1797,2441,2336,105,1330,1006,2508,1471,1037,65,982,25,85057,5495,148,380700,6061020604,64
06061021005,Sacramento,5518,1848,220,4564,30,383,379,144,2697,2821,1685,1765,2628,2538,90,1462,1076,2671,1450,1221,48,1173,202,86536,5509,0,226800,6061021005,65
06017031405,Sacramento,2412,461,487,2301,0,0,46,9,1200,1212,721,743,1121,1062,59,471,591,1130,627,503,64,259,7,48992,2412,188,173200,6017031405,66
06061021006,Sacramento,5326,0,3806,5054,0,91,139,42,2312,3014,494,1026,612,547,65,293,254,691,296,395,11,242,24,49398,5326,167,243400,6061021006,67
06061020800,Sacramento,7396,1454,1064,5929,76,211,905,193,3436,3960,2261,2617,3805,3673,132,2491,1182,3829,1935,1894,195,811,104,44698,7373,471,148800,6061020800,68
06061021007,Sacramento,11135,3380,637,8709,172,631,1056,461,5362,5773,3447,3671,5656,5450,206,3281,2169,5677,3056,2621,167,1871,325,66489,11074,202,187200,6061021007,69
06113011206,Sacramento,2884,586,296,1903,110,5,797,69,1686,1198,1193,809,1148,1096,52,913,183,1174,672,502,77,230,13,47072,2471,196,221900,6113011206,70
06061020705,Sacramento,8921,2102,1222,7464,167,520,513,150,4062,4859,2618,2979,4289,4104,185,2449,1655,4381,2292,2089,63,1506,189,70088,8773,451,225800,6061020705,71
06061020702,Sacramento,7189,1341,1708,5992,77,62,774,253,3290,3899,2025,2115,3012,2915,97,1991,924,3084,1653,1431,93,826,64,42165,6681,572,156700,6061020702,72
06061020605,Sacramento,5312,1548,342,4641,31,288,280,52,2702,2610,1678,1744,2213,2094,119,1188,906,2267,1420,847,40,1046,95,111255,5302,150,421200,6061020605,73
06067007100,Sacramento,1110,274,146,740,31,73,224,5,553,557,319,371,501,496,5,364,132,511,263,248,25,169,22,65000,1105,133,199100,6067007100,74
06067007206,Sacramento,4196,1057,319,3155,84,55,589,154,2077,2119,1412,1408,1922,1828,94,954,874,1975,1025,950,106,364,28,50952,4172,356,122900,6067007206,75
06017031200,Sacramento,4824,886,888,4149,13,23,463,131,2383,2441,1543,1507,2048,1933,115,1210,723,2153,1128,1025,140,473,80,43423,4482,621,172400,6017031200,76
06061020901,Sacramento,2855,622,275,1743,0,21,1035,41,1394,1461,980,978,1135,1062,73,637,425,1155,616,539,57,151,35,33274,2855,590,112400,6061020901,77
06061020902,Sacramento,7513,2108,735,5045,69,337,1805,159,3751,3762,2370,2300,3399,3213,186,1977,1236,3442,1945,1497,184,762,182,44609,7484,699,138600,6061020902,78
06061020606,Sacramento,4233,1551,129,3502,18,301,197,207,2129,2104,1287,1266,1691,1467,224,844,623,1718,1115,603,19,822,97,128578,4233,42,412200,6061020606,79
06061020703,Sacramento,7178,1768,731,6093,22,202,547,300,3473,3705,2304,2375,3553,3381,172,2160,1221,3563,1910,1653,89,1028,136,63688,7069,198,203000,6061020703,80
06067007417,Sacramento,3147,884,223,1672,295,484,312,327,1545,1602,950,1090,1517,1475,42,965,510,1524,777,747,86,326,59,50583,3140,172,123400,6067007417,81
06067007418,Sacramento,10826,3475,367,6617,965,1460,1072,534,5350,5476,3288,3696,5149,4960,189,2728,2232,5226,2676,2550,275,1394,206,63438,10728,468,153500,6067007418,82
06067007419,Sacramento,10122,3250,460,6523,839,1063,1101,505,5010,5112,3014,3398,5046,4894,152,2663,2231,5094,2581,2513,299,1384,254,59054,10072,642,148700,6067007419,83
06067007421,Sacramento,4168,1245,100,2667,388,310,394,330,2056,2112,1364,1459,2262,2157,105,1126,1031,2313,1180,1133,57,769,141,76564,4163,87,168100,6067007421,84
06017031402,Sacramento,4844,1012,689,4435,0,0,205,123,2451,2393,1568,1575,2121,1948,173,529,1419,2171,1188,983,135,477,74,46272,4790,335,165400,6017031402,85
06067008128,Sacramento,2551,577,402,2031,34,87,289,98,1258,1293,836,736,1126,1099,27,668,431,1132,594,538,49,191,22,44677,2537,257,108500,6067008128,86
06067008127,Sacramento,5107,1333,241,3967,175,220,578,160,2564,2543,1822,1711,2651,2597,54,1678,919,2686,1478,1208,172,402,33,51250,5090,338,121600,6067008127,87
06067008113,Sacramento,3896,1017,284,3090,103,47,520,74,1962,1934,1253,1342,1941,1887,54,1160,727,1962,1009,953,162,289,24,37321,3883,461,104300,6067008113,88
06067008124,Sacramento,4806,1094,446,4033,57,149,387,139,2361,2445,1632,1634,2371,2245,126,1387,858,2392,1255,1137,19,578,97,63250,4754,180,160300,6067008124,89
06017031404,Sacramento,2197,304,280,2052,0,0,84,54,1084,1113,788,825,1164,1109,55,483,626,1164,605,559,65,356,45,50865,2177,145,203600,6017031404,90
06067007420,Sacramento,8166,2582,365,4646,1080,846,1015,415,3986,4180,2561,2658,3943,3799,144,2356,1443,3607,1732,1875,64,806,173,47328,8141,594,135000,6067007420,91
06067008203,Sacramento,4942,1095,650,4277,76,89,239,165,2502,2440,1623,1574,2454,2343,111,1367,976,2479,1283,1196,79,702,93,57098,4905,274,170600,6067008203,92
06017031502,Sacramento,5643,1197,1352,4889,0,38,450,133,2619,3024,1467,1627,2163,2064,99,1279,785,2219,1112,1107,118,423,25,37500,5527,688,150900,6017031502,93
06067008501,Sacramento,4657,1436,246,3853,109,186,355,139,2348,2309,1471,1504,2442,2277,165,1243,1034,2451,1349,1102,75,979,109,88865,4618,74,228000,6067008501,94
06067008211,Sacramento,2677,619,431,2202,5,93,275,50,1337,1340,793,834,1184,1105,79,551,554,1216,606,610,22,286,31,62500,2634,128,206400,6067008211,95
06067008125,Sacramento,5489,1344,735,4584,108,99,424,200,2653,2836,1679,1731,2620,2538,82,1450,1088,2665,1443,1222,117,628,56,54696,5430,257,148400,6067008125,96
06017030703,Sacramento,7059,2178,499,6135,0,351,353,189,3520,3539,2084,2298,3386,3184,202,1497,1687,3430,1920,1510,124,1419,109,92743,7036,98,277800,6017030703,97
06017030803,Sacramento,5795,1311,827,5118,8,71,370,186,2776,3019,1730,1927,2704,2573,131,1468,1105,2783,1472,1311,109,789,82,59216,5769,277,200800,6017030803,98
06067007207,Sacramento,3965,1167,326,3142,37,181,410,123,1992,1973,1229,1243,1497,1466,31,779,687,1512,806,706,71,307,53,45938,3915,504,115200,6067007207,99
06067008210,Sacramento,4693,844,1180,4263,59,109,122,128,2162,2531,1246,1423,2054,1995,59,1140,855,2083,1113,970,24,793,74,60098,4693,150,214600,6067008210,100
06017030702,Sacramento,5766,1575,484,5011,236,101,301,93,2953,2813,1894,1813,2768,2631,137,1409,1222,2784,1660,1124,37,1139,99,95425,5730,53,245100,6017030702,101
06067008143,Sacramento,4037,891,422,3297,50,102,416,129,2038,1999,1363,1361,2055,2031,24,1325,706,2061,1068,993,93,352,35,39304,3991,419,138300,6067008143,102
06067008142,Sacramento,3509,885,195,2791,181,66,247,179,1674,1835,1181,1248,1874,1838,36,1075,763,1886,938,948,107,417,50,38185,3497,462,146400,6067008142,103
06067008111,Sacramento,6628,1618,885,5479,77,198,570,263,3284,3344,2043,2082,3040,2904,136,1660,1244,3099,1626,1473,114,626,92,46789,6509,309,124200,6067008111,104
06067008132,Sacramento,3380,680,898,2932,31,101,149,145,1667,1713,886,916,1329,1297,32,888,409,1387,782,605,87,297,71,47167,3319,153,117700,6067008132,105
06067008129,Sacramento,3566,877,481,2889,119,136,317,91,1787,1779,1119,1089,1706,1660,46,1010,650,1754,921,833,65,287,39,44762,3547,342,113600,6067008129,106
06067008130,Sacramento,3964,1119,312,2993,210,133,378,154,1865,2099,1213,1320,1809,1785,24,1204,581,1828,951,877,65,376,63,44567,3915,473,113400,6067008130,107
06067007406,Sacramento,6981,1971,890,4204,1009,375,901,395,3369,3612,1915,2205,2476,2403,73,1365,1038,2546,1346,1200,187,382,88,38166,6899,1379,96600,6067007406,108
06067007425,Sacramento,8103,2097,417,5400,734,453,1018,412,3890,4213,2677,2912,4156,4099,57,2359,1740,4129,2136,1993,312,766,127,45558,8059,521,121400,6067007425,109
06067008300,Sacramento,6828,0,22,2329,2460,69,1831,114,6778,50,6756,50,401,287,114,148,139,401,359,42,12,68,24,56042,3680,1963,0,6067008300,110
06067008140,Sacramento,3058,664,382,2452,78,107,227,187,1464,1594,972,1040,1419,1331,88,633,698,1467,824,643,57,336,82,50753,2910,264,148300,6067008140,111
06067007422,Sacramento,2424,766,176,1614,113,163,322,119,1113,1311,674,808,1043,1026,17,641,385,1102,546,556,65,208,36,36754,2419,229,110800,6067007422,112
06067008145,Sacramento,7766,1922,617,6470,112,384,582,163,3962,3804,2614,2613,4030,3880,150,2121,1759,4089,2136,1953,222,966,130,61089,7736,243,146900,6067008145,113
06067008120,Sacramento,4430,986,398,3441,133,158,434,154,2178,2252,1487,1559,2411,2359,52,1215,1144,2452,1211,1241,84,615,85,48955,4415,281,146400,6067008120,114
06067007208,Sacramento,4130,1074,378,3124,114,219,459,204,2072,2058,1302,1376,1725,1696,29,1210,486,1772,908,864,137,332,53,43862,4071,741,114200,6067007208,115
06067008209,Sacramento,4158,794,467,3483,69,219,232,109,2100,2058,1427,1470,2193,2010,183,1092,918,2196,1285,911,26,937,154,82107,4158,86,276300,6067008209,116
06017030806,Sacramento,5182,1241,695,4496,26,63,418,124,2460,2722,1537,1709,2512,2369,143,1338,1031,2551,1286,1265,54,817,142,56756,5149,260,195200,6017030806,117
06017030805,Sacramento,9199,2650,708,8088,53,196,609,211,4534,4665,2865,2976,4482,4266,216,2191,2075,4579,2485,2094,241,1643,301,71321,9150,443,203400,6017030805,118
06067007209,Sacramento,3457,972,349,2843,0,50,429,77,1664,1793,1043,1093,1405,1361,44,802,559,1455,698,757,97,272,33,42895,3444,452,111300,6067007209,119
06067007202,Sacramento,3743,937,471,2849,106,196,411,136,1830,1913,1151,1184,1502,1433,69,911,522,1530,830,700,70,220,23,37095,3728,530,121800,6067007202,120
06017030902,Sacramento,4341,866,555,3829,12,35,254,112,2211,2130,1476,1444,2035,1844,191,916,928,2084,1155,929,83,611,89,60563,4321,403,251600,6017030902,121
06017030804,Sacramento,5758,1370,669,5121,15,76,351,90,2813,2945,1812,1907,2668,2455,213,1170,1285,2714,1480,1234,78,794,86,66635,5749,200,255000,6017030804,122
06017031504,Sacramento,5273,1081,1015,4679,0,19,340,176,2529,2744,1570,1607,2060,1888,172,1194,694,2156,1149,1007,162,385,48,39651,5243,433,147500,6017031504,123
06067008402,Sacramento,5757,1497,558,4955,45,135,466,140,2878,2879,1850,1852,2807,2711,96,1561,1150,2934,1561,1373,132,828,125,61295,5713,213,182200,6067008402,124
06067007414,Sacramento,4338,1405,175,2605,457,236,605,310,2071,2267,1298,1460,1865,1845,20,1215,630,1917,1023,894,149,254,54,37035,4315,512,96600,6067007414,125
06067008136,Sacramento,2354,344,753,2016,69,33,151,67,969,1385,596,661,931,915,16,548,367,968,484,484,29,263,51,40076,2203,102,144200,6067008136,126
06067007402,Sacramento,6244,1687,972,3869,559,223,998,383,3065,3179,1774,1811,2150,2126,24,1324,802,2248,1195,1053,180,287,59,40152,6181,1203,90200,6067007402,127
06067008131,Sacramento,5088,958,762,3872,288,204,597,120,2499,2589,1689,1679,2520,2421,99,1533,888,2574,1337,1237,49,493,42,35058,5037,603,93900,6067008131,128
06067008208,Sacramento,4633,1078,527,3789,150,88,410,111,2263,2370,1481,1547,2117,2056,61,1089,967,2129,1123,1006,98,400,66,43333,4575,569,145400,6067008208,129
06113010901,Sacramento,5246,1400,503,2604,75,225,2212,86,2584,2662,1628,1715,2307,2279,28,1747,532,2347,1229,1118,186,332,54,44524,5045,607,130200,6113010901,130
06067008144,Sacramento,2429,465,231,2090,7,65,196,71,1156,1273,844,889,1287,1207,80,737,470,1314,692,622,50,357,108,63646,2394,108,157600,6067008144,131
06113010800,Sacramento,4100,1237,392,1653,7,155,2176,75,2142,1958,1304,1167,1503,1429,74,1230,199,1551,867,684,132,260,21,36318,4054,983,151700,6113010800,132
06067008141,Sacramento,6559,1628,498,4727,277,212,1020,218,3346,3213,2273,2160,3038,2983,55,1943,1040,3135,1769,1366,117,389,62,32346,6482,999,125800,6067008141,133
06067007416,Sacramento,4123,1037,503,2722,339,248,628,117,2055,2068,1272,1311,1513,1496,17,969,527,1542,746,796,97,230,47,37527,4102,784,93700,6067007416,134
06067008135,Sacramento,4013,636,1102,3268,215,54,292,93,1667,2346,1000,1275,1811,1731,80,1145,586,1836,831,1005,79,310,47,33434,3952,326,108100,6067008135,135
06067007300,Sacramento,606,73,8,323,174,44,28,37,321,285,278,247,436,436,0,396,40,121,24,97,0,37,0,32266,368,0,350000,6067007300,136
06067007415,Sacramento,3083,729,422,2285,286,76,275,84,1491,1592,939,993,1277,1270,7,852,418,1289,646,643,88,247,27,51672,3046,179,132600,6067007415,137
06067007403,Sacramento,4594,1398,543,2667,452,230,858,281,2217,2377,1314,1339,1515,1475,40,887,588,1581,846,735,107,159,5,36921,4508,686,87800,6067007403,138
06067008502,Sacramento,5927,1623,373,4571,44,689,419,119,2936,2991,1937,1994,3022,2784,238,1423,1361,3078,1676,1402,63,1464,291,85274,5908,192,260500,6067008502,139
06067008404,Sacramento,3475,642,478,2648,53,94,396,211,1725,1750,1208,1147,1829,1791,38,1148,643,1856,1022,834,55,382,60,37368,3359,447,149600,6067008404,140
06113010902,Sacramento,6247,1464,706,3038,94,150,2608,230,3009,3238,2026,2051,2517,2423,94,1934,489,2604,1327,1277,199,406,58,35142,6214,688,132300,6113010902,141
06067007501,Sacramento,6301,1594,702,4682,342,271,536,345,2974,3327,1941,2064,2994,2912,82,2009,903,3023,1596,1427,169,574,85,35838,6184,943,128700,6067007501,142
06017031503,Sacramento,2646,554,460,2449,0,43,112,42,1329,1317,842,790,1115,1008,107,500,508,1156,655,501,52,292,26,51705,2628,219,202500,6017031503,143
06067007404,Sacramento,4073,1228,350,2332,333,200,908,255,2021,2052,1252,1243,1462,1405,57,917,488,1470,824,646,148,89,16,31105,4039,1193,80400,6067007404,144
06067008207,Sacramento,4488,1026,544,3833,9,166,289,146,2188,2300,1411,1507,2263,2143,120,1230,913,2323,1175,1148,69,620,168,60813,4488,219,169100,6067008207,145
06067008134,Sacramento,4708,982,542,3592,262,48,451,271,2225,2483,1503,1681,2549,2493,56,1670,823,2576,1314,1262,100,426,102,36975,4699,574,129700,6067008134,146
06067008122,Sacramento,3402,594,512,2829,48,156,204,158,1725,1677,1169,1127,1732,1624,108,969,655,1757,974,783,33,595,90,55817,3337,282,197400,6067008122,147
06067008204,Sacramento,4496,1015,648,3808,57,139,298,172,2221,2275,1429,1404,2252,2122,130,1200,922,2249,1184,1065,56,689,106,59536,4465,320,156100,6067008204,148
06067008139,Sacramento,3208,547,486,2239,142,99,635,85,1449,1759,1002,1173,1720,1689,31,1090,599,1705,799,906,68,348,54,32454,3201,490,130800,6067008139,149
06067008206,Sacramento,5506,1327,450,4620,15,77,419,283,2664,2842,1837,1892,2733,2692,41,1792,900,2808,1452,1356,102,716,118,47786,5463,314,145800,6067008206,150
06067008138,Sacramento,3670,742,667,2794,23,149,475,122,1801,1869,1149,1112,1702,1655,47,983,672,1753,932,821,37,365,74,57103,3519,105,161500,6067008138,151
06067008137,Sacramento,2195,549,360,1829,26,85,125,124,1011,1184,584,702,1034,1007,27,565,442,1062,549,513,74,164,34,45368,2190,213,147400,6067008137,152
06067008119,Sacramento,6004,1454,683,4853,136,111,520,275,2990,3014,1914,1953,2761,2643,118,1502,1141,2823,1444,1379,111,460,112,45271,5968,631,138200,6067008119,153
06067007423,Sacramento,5019,1422,159,2345,910,233,982,447,2324,2695,1604,1834,2151,2130,21,1403,727,2225,1117,1108,106,315,35,30048,4984,866,90000,6067007423,154
06113011001,Sacramento,6544,1714,740,3403,35,162,2584,267,3194,3350,2035,2055,2795,2697,98,2080,617,2856,1545,1311,164,463,41,33053,6442,937,171800,6113011001,155
06113011101,Sacramento,3154,783,471,1620,56,9,1410,59,1522,1632,934,966,1147,1109,38,799,310,1176,641,535,99,215,20,36818,3080,694,142000,6113011101,156
06113011102,Sacramento,4908,1594,354,1617,97,148,2934,67,2496,2412,1472,1488,1958,1906,52,1464,442,2065,1124,941,177,124,28,34977,4897,796,113000,6113011102,157
06113011103,Sacramento,3225,876,193,1576,0,286,1209,143,1586,1639,1090,1066,1518,1479,39,1087,392,1545,878,667,140,291,37,49659,3225,219,139700,6113011103,158
06113011205,Sacramento,4095,1218,215,2155,33,311,1382,121,1911,2184,1280,1382,1913,1896,17,1400,496,1941,1100,841,88,408,21,58958,4095,120,168800,6113011205,159
06067008403,Sacramento,4130,987,498,3220,41,371,201,260,1938,2192,1256,1389,1955,1886,69,1131,755,2002,1094,908,44,858,235,67941,4123,122,208400,6067008403,160
06067008133,Sacramento,2778,754,269,2133,84,111,295,126,1326,1452,844,911,1209,1161,48,642,519,1239,631,608,62,210,35,30293,2772,668,90900,6067008133,161
06113011002,Sacramento,3370,642,738,2653,32,70,524,76,1626,1744,977,1013,1455,1407,48,1021,386,1479,812,667,78,302,40,60319,3353,237,185100,6113011002,162
06067007204,Sacramento,4289,1203,266,2361,425,485,686,153,2149,2140,1424,1396,1860,1806,54,1250,556,1953,1094,859,98,467,74,47120,4243,637,119500,6067007204,163
06067008503,Sacramento,8045,2271,289,6058,111,980,579,294,3923,4122,2657,2828,4165,3989,176,2182,1807,4264,2367,1897,70,1929,405,84279,8045,246,222100,6067008503,164
06067008504,Sacramento,4242,1236,194,3074,55,764,284,65,2053,2189,1369,1443,2185,2026,159,1324,702,2200,1173,1027,37,1023,169,74713,4236,48,214500,6067008504,165
06067007424,Sacramento,3760,1191,187,2112,646,151,613,151,1886,1874,1195,1187,1640,1590,50,1069,521,1641,913,728,103,185,23,33708,3720,782,102400,6067007424,166
06067008117,Sacramento,2107,446,363,1761,72,46,141,71,1044,1063,640,658,960,911,49,569,342,1013,530,483,47,221,62,47102,2004,129,124000,6067008117,167
06067008005,Sacramento,5207,1159,503,4316,0,320,308,189,2568,2639,1732,1813,2750,2621,129,1658,963,2786,1512,1274,40,1080,200,84188,5199,177,238500,6067008005,168
06067008006,Sacramento,5579,1107,689,4732,91,317,233,174,2712,2867,1831,1952,2911,2811,100,1795,1016,2951,1551,1400,93,1083,171,71450,5540,178,241500,6067008006,169
06067008008,Sacramento,4578,807,851,3990,3,208,299,73,2236,2342,1424,1496,2425,2325,100,1345,980,2451,1267,1184,85,860,188,65370,4415,90,210000,6067008008,170
06067008007,Sacramento,3494,792,581,2817,112,162,274,67,1630,1864,997,1124,1596,1519,77,845,674,1663,875,788,68,373,47,50417,3487,567,206600,6067008007,171
06067007904,Sacramento,5172,1200,753,4412,22,115,348,89,2543,2629,1582,1637,2419,2304,115,1351,953,2482,1294,1188,75,628,103,50697,5116,477,148800,6067007904,172
06067007903,Sacramento,4583,924,866,3802,124,204,299,120,2195,2388,1347,1446,2256,2193,63,1396,797,2291,1207,1084,66,667,142,58068,4563,248,161300,6067007903,173
06113011203,Sacramento,2805,609,324,2348,0,16,405,22,1312,1493,879,993,1537,1503,34,1150,353,1542,813,729,44,385,35,63086,2805,41,178400,6113011203,174
06113011204,Sacramento,5063,1363,489,2926,20,239,1581,231,2503,2560,1582,1629,2363,2269,94,1786,483,2430,1309,1121,143,413,40,57034,5021,397,151900,6113011204,175
06067007413,Sacramento,6332,1923,658,3577,766,424,1071,420,3073,3259,1771,1980,2076,2049,27,1365,684,2111,1076,1035,244,267,12,25966,6309,2160,74100,6067007413,176
06067007503,Sacramento,5185,1384,438,3314,467,441,593,248,2420,2765,1579,1784,1990,1963,27,1316,647,2022,1145,877,60,379,109,28062,5123,1273,131400,6067007503,177
06067007601,Sacramento,6553,1242,1248,5234,245,257,515,211,2970,3583,1880,2183,3137,3007,130,2009,998,3202,1608,1594,89,753,112,42378,6546,601,183600,6067007601,178
06017030704,Sacramento,1905,430,193,1683,4,4,64,125,962,943,668,614,934,868,66,358,510,972,557,415,61,284,42,74375,1902,132,320700,6017030704,179
06067007008,Sacramento,1186,125,217,883,26,102,134,31,541,645,410,434,538,499,39,347,152,538,290,248,30,130,6,51103,1186,47,154100,6067007008,180
06067006500,Sacramento,5890,2064,555,1498,2092,965,958,211,2796,3094,1523,1748,1761,1711,50,1046,665,1782,836,946,127,215,28,28047,5872,1869,95900,6067006500,181
06067006701,Sacramento,7862,2533,469,2684,1702,1113,1898,215,3818,4044,2306,2554,3025,2944,81,2144,800,3093,1582,1511,256,482,103,36311,7523,1505,104100,6067006701,182
06067007001,Sacramento,3097,865,393,1093,106,124,1565,124,1621,1476,954,885,927,894,33,636,258,982,549,433,124,101,28,21302,3034,1032,79800,6067007001,183
06067007504,Sacramento,2154,427,369,1469,151,100,314,102,1027,1127,675,683,1004,956,48,684,272,1016,563,453,29,262,102,39900,1962,368,175900,6067007504,184
06113010505,Sacramento,2961,685,180,2151,22,351,258,175,1401,1560,1016,1080,1576,1437,139,1059,378,1575,825,750,28,596,64,58800,2955,185,315600,6113010505,185
06067006400,Sacramento,5290,1675,535,3041,648,289,975,217,2547,2743,1394,1686,1733,1634,99,1019,615,1759,884,875,166,132,10,28167,5255,1339,70300,6067006400,186
06067008009,Sacramento,4338,844,566,3682,72,81,293,185,2171,2167,1462,1466,2167,1997,170,1179,818,2229,1177,1052,36,687,135,52902,4293,366,261200,6067008009,187
06067008010,Sacramento,4812,975,610,4020,118,85,324,219,2422,2390,1589,1638,2420,2308,112,1437,871,2448,1365,1083,95,875,119,55765,4766,412,194000,6067008010,188
06113011300,Sacramento,7572,2256,615,3721,27,85,3470,205,3790,3782,2340,2361,3322,3155,167,1944,1211,3365,1802,1563,219,543,72,47129,7533,592,151500,6113011300,189
06067007905,Sacramento,4075,810,706,3484,46,76,217,200,1912,2163,1181,1378,1909,1783,126,1101,682,1920,951,969,37,566,80,59531,4051,290,189200,6067007905,190
06067007906,Sacramento,3662,652,614,3080,119,134,257,72,1796,1866,1169,1227,1953,1844,109,1148,696,2009,1084,925,66,586,62,50122,3643,155,169600,6067007906,191
06067005901,Sacramento,5707,908,1680,4812,153,134,340,191,2581,3126,1468,1651,2289,2164,125,1565,599,2278,1114,1164,114,704,82,58561,5333,352,172300,6067005901,192
06067008701,Sacramento,5145,1103,768,3621,99,917,246,181,2396,2749,1526,1748,2620,2508,112,1625,883,2650,1370,1280,31,1322,179,84740,5123,31,235800,6067008701,193
06067006702,Sacramento,7745,3129,499,1229,1968,2417,1382,473,3821,3924,2044,2073,1746,1689,57,1151,538,1795,977,818,210,200,61,25702,7695,2915,83400,6067006702,194
06067006003,Sacramento,4687,1139,593,3442,237,296,453,166,2294,2393,1458,1497,1776,1740,36,1243,497,1829,952,877,93,365,102,29891,4605,1033,142900,6067006003,195
06067007004,Sacramento,6899,2001,162,1974,1394,755,2077,460,3425,3474,2345,2391,3287,3221,66,2292,929,3372,1708,1664,198,789,38,43228,6782,743,117800,6067007004,196
06067007602,Sacramento,4470,939,771,3539,179,159,393,187,2081,2389,1332,1428,1994,1931,63,1355,576,2040,1027,1013,87,570,79,41567,4333,546,152300,6067007602,197
06067008702,Sacramento,3355,802,441,2729,15,384,84,130,1584,1771,965,1147,1647,1533,114,946,587,1671,885,786,31,902,96,97501,3355,46,290500,6067008702,198
06067006101,Sacramento,4851,1042,729,3276,509,247,570,200,2508,2343,1620,1460,1950,1885,65,1458,427,1989,1099,890,111,405,29,36557,4820,803,140500,6067006101,199
06067007801,Sacramento,5604,1206,758,4544,232,142,474,202,2817,2787,1795,1845,2800,2661,139,1805,856,2821,1448,1373,100,822,130,49241,5446,588,182300,6067007801,200
06067008912,Sacramento,3376,599,239,2326,334,193,420,61,1677,1699,1247,1291,1998,1930,68,1376,554,2004,1072,932,49,598,67,58824,3347,247,144400,6067008912,201
06067006600,Sacramento,6417,2073,478,2470,1333,788,1518,184,3231,3186,1975,1891,1931,1869,62,1184,685,1966,1031,935,162,175,26,22272,6399,2285,74600,6067006600,202
06067006300,Sacramento,4462,1063,430,2684,284,192,980,231,2089,2373,1441,1528,1651,1599,52,1141,458,1695,928,767,112,231,23,30244,4386,1154,83500,6067006300,203
06067008600,Sacramento,5412,982,1105,4566,136,86,409,155,2706,2706,1646,1679,2394,2170,224,741,1429,2422,1358,1064,79,930,83,77236,5307,200,241900,6067008600,204
06067008913,Sacramento,4534,1261,496,3415,318,138,372,251,2252,2282,1351,1426,1764,1717,47,1221,496,1820,1020,800,102,324,39,41331,4534,732,117000,6067008913,205
06067006201,Sacramento,6720,1832,671,3981,759,262,1378,274,3274,3446,2045,2172,2636,2559,77,1934,625,2698,1508,1190,143,418,45,26430,6695,1944,120500,6067006201,206
06067007007,Sacramento,5601,1734,463,1863,768,334,2372,129,2846,2755,1700,1704,1912,1863,49,1395,468,1972,987,985,173,377,63,45297,5513,1151,102600,6067007007,207
06067006004,Sacramento,2418,370,546,2033,89,63,166,67,1085,1333,677,825,1219,1187,32,904,283,1219,524,695,15,379,39,60856,2393,135,170800,6067006004,208
06067007013,Sacramento,2790,752,98,1263,433,228,750,116,1368,1422,922,1018,1396,1357,39,861,496,1403,671,732,62,401,90,47031,2779,443,119200,6067007013,209
06067005902,Sacramento,7302,1358,1167,5814,265,306,565,292,3335,3967,2159,2618,3694,3581,113,2522,1059,3770,1717,2053,73,914,118,35804,7110,755,168800,6067005902,210
06067007012,Sacramento,3410,851,158,1537,609,245,729,204,1661,1749,1125,1276,1914,1891,23,1490,401,1923,959,964,46,567,100,50384,3382,270,113000,6067007012,211
06067007011,Sacramento,5978,1588,208,2375,899,709,1512,329,2993,2985,2106,2076,3130,3063,67,2523,540,3215,1798,1417,128,851,219,38397,5966,598,131900,6067007011,212
06067007802,Sacramento,5016,1100,822,4275,195,75,328,82,2399,2617,1474,1620,2174,2115,59,1507,608,2205,1141,1064,56,609,72,45660,4815,614,256200,6067007802,213
06067006800,Sacramento,7884,2724,555,1672,814,1610,3336,401,4002,3882,2304,2301,2207,2118,89,1376,742,2256,1355,901,280,171,11,23903,7842,3041,79700,6067006800,214
06067007010,Sacramento,2696,403,97,1654,335,203,381,111,1328,1368,1089,1107,1857,1793,64,1493,300,1885,988,897,32,916,153,50365,2696,167,217600,6067007010,215
06067007701,Sacramento,6036,1119,865,4757,208,191,508,257,2910,3126,2017,2035,2973,2849,124,2051,798,3140,1615,1525,210,694,75,36918,5835,924,160200,6067007701,216
06067007014,Sacramento,7095,1894,476,2708,963,477,2012,680,3316,3779,2211,2514,3366,3263,103,2466,797,3479,1682,1797,210,804,144,44750,6999,922,118100,6067007014,217
06067006002,Sacramento,4432,891,750,3391,202,108,463,204,2077,2355,1319,1472,2147,2104,43,1476,628,2153,1037,1116,58,533,101,35561,4418,570,138800,6067006002,218
06067007009,Sacramento,1151,149,123,852,81,47,155,16,583,568,455,424,802,774,28,607,167,808,422,386,0,271,42,57938,1151,27,220100,6067007009,219
06067008908,Sacramento,4998,1155,926,3634,433,145,578,159,2451,2547,1452,1465,2095,2024,71,1551,473,2136,1113,1023,148,385,40,40394,4976,799,103700,6067008908,220
06067008907,Sacramento,5235,1342,599,3608,424,443,541,169,2546,2689,1596,1698,2167,2125,42,1472,653,2233,1203,1030,155,461,125,40219,5198,694,104900,6067008907,221
06067006102,Sacramento,3476,455,923,2616,234,78,415,68,1366,2110,869,1229,1512,1404,108,1077,327,1537,654,883,54,414,64,30531,3359,358,176400,6067006102,222
06067005502,Sacramento,5611,1477,555,2514,618,295,1764,343,2778,2833,1793,1786,2300,2260,40,1591,669,2346,1280,1066,132,364,15,29977,5584,1565,103600,6067005502,223
06067006202,Sacramento,3912,999,369,2083,258,399,918,180,2004,1908,1263,1281,1409,1392,17,1040,352,1439,730,709,88,195,35,24180,3900,1267,81800,6067006202,224
06067006900,Sacramento,4869,1037,633,2526,524,118,1426,228,2410,2459,1675,1524,1820,1767,53,1301,466,1839,1066,773,99,279,60,25197,4852,1484,92400,6067006900,225
06067005505,Sacramento,4338,838,662,2493,501,229,786,245,2036,2302,1391,1447,1931,1886,45,1453,433,1999,1082,917,116,440,81,31341,4213,664,105000,6067005505,226
06067005601,Sacramento,4773,717,1261,3565,266,208,530,163,1982,2791,1270,1525,2265,2233,32,1712,521,2296,1087,1209,91,612,119,41659,4433,290,141500,6067005601,227
06067005701,Sacramento,3027,556,664,2498,56,129,233,96,1414,1613,823,984,1439,1366,73,1162,204,1487,764,723,17,489,69,54063,3021,128,173700,6067005701,228
06067005801,Sacramento,5274,1003,1053,4390,35,172,425,207,2477,2797,1526,1692,2500,2407,93,1813,594,2517,1222,1295,26,710,66,49321,5249,395,160900,6067005801,229
06067007702,Sacramento,4571,826,1106,3938,161,139,227,79,2079,2492,1265,1374,1971,1758,213,1286,472,2012,1054,958,17,660,73,58487,4566,337,247500,6067007702,230
06067008905,Sacramento,5003,1285,695,3237,396,313,741,238,2410,2593,1489,1534,1925,1864,61,1254,610,1932,1026,906,112,365,51,39093,4816,797,116800,6067008905,231
06067009009,Sacramento,3903,735,96,2033,370,743,518,173,2027,1876,1595,1477,2396,2379,17,1895,484,2377,1256,1121,104,884,326,40717,3886,394,160800,6067009009,232
06113010101,Sacramento,5665,1681,737,2242,227,549,2390,185,2891,2774,1707,1540,1684,1630,54,1221,409,1738,922,816,140,176,19,25083,5641,1710,83800,6113010101,233
06067008910,Sacramento,3581,860,463,2380,137,144,437,393,1686,1895,1037,1221,1642,1571,71,1110,461,1649,749,900,96,416,62,44488,3521,280,111700,6067008910,234
06067005402,Sacramento,2655,330,375,1756,175,310,157,250,1174,1481,932,1018,1450,1426,24,1100,326,1443,709,734,65,471,102,31729,2655,566,112500,6067005402,235
06067005300,Sacramento,1483,229,70,454,512,154,250,73,970,513,866,318,255,255,0,159,96,274,171,103,24,39,17,13750,1447,914,92500,6067005300,236
06067005506,Sacramento,2989,676,112,1412,449,292,657,179,1524,1465,1093,1108,1473,1452,21,1098,354,1507,795,712,29,281,24,29787,2966,697,123900,6067005506,237
06067005605,Sacramento,3677,951,350,2304,252,162,624,229,1788,1889,1180,1196,1649,1635,14,1277,358,1660,868,792,88,375,53,33056,3671,793,110600,6067005605,238
06067009008,Sacramento,5341,1528,387,3027,601,345,902,450,2566,2775,1683,1743,1898,1830,68,1407,423,1949,1041,908,190,340,96,34037,5314,1168,100500,6067009008,239
06067005702,Sacramento,4749,1114,965,4245,19,64,230,110,2232,2517,1312,1358,2132,2028,104,1718,310,2182,1158,1024,31,958,106,75491,4736,85,262400,6067005702,240
06067005803,Sacramento,3491,607,931,3067,16,214,143,40,1682,1809,918,1035,1511,1470,41,1199,271,1530,874,656,24,642,89,83851,3487,159,318300,6067005803,241
06067005804,Sacramento,2659,459,571,2273,46,213,50,77,1256,1403,774,855,1261,1173,88,989,184,1280,764,516,12,499,20,83903,2659,115,315200,6067005804,242
06067008911,Sacramento,2297,836,168,1289,304,194,353,104,1064,1233,580,713,911,911,0,590,321,911,446,465,44,169,10,25706,2287,677,132400,6067008911,243
06113010510,Sacramento,5413,900,318,3320,126,1254,417,278,2436,2977,1867,2328,2845,2772,73,2105,667,2890,1385,1505,72,1137,58,39621,5400,1703,278400,6113010510,244
06067000600,Sacramento,930,120,120,533,24,60,276,18,478,452,332,358,425,417,8,328,89,434,239,195,4,119,48,17341,930,289,188800,6067000600,245
06067005507,Sacramento,6262,793,361,3489,662,493,1106,455,3018,3244,2451,2657,3587,3544,43,2708,836,3678,1800,1878,127,948,201,30777,6235,1391,72100,6067005507,246
06067000500,Sacramento,3431,530,240,1699,181,272,1147,97,1772,1659,1360,1301,1733,1708,25,1294,414,1795,923,872,84,407,84,24340,3369,905,132000,6067000500,247
06113010204,Sacramento,4905,1120,917,3073,56,271,1149,233,2305,2600,1354,1514,1920,1850,70,1455,395,1975,998,977,173,313,58,32331,4905,796,106300,6113010204,248
06113010203,Sacramento,5370,1612,612,2333,239,578,1925,111,2770,2600,1593,1553,1707,1670,37,1328,342,1782,968,814,145,124,18,20602,5282,1732,14400,6113010203,249
06067000100,Sacramento,3558,543,787,3135,13,75,211,74,1645,1913,1067,1161,1926,1882,44,1521,361,1954,976,978,46,504,75,53318,3552,170,184400,6067000100,250
06067000700,Sacramento,2617,3,441,926,700,336,470,119,1828,789,1630,543,74,74,0,16,58,74,40,34,0,29,10,9879,573,105,0,6067000700,251
06067009006,Sacramento,4660,1174,454,2436,738,538,548,313,2152,2508,1427,1605,2100,2043,57,1349,694,2130,1140,990,106,440,33,34565,4638,584,42000,6067009006,252
06113010201,Sacramento,2551,541,460,1850,0,99,410,138,1175,1376,773,777,1013,963,50,787,176,1037,525,512,18,213,54,35467,2539,304,99600,6113010201,253
06067000400,Sacramento,3776,331,238,2510,278,85,717,150,2058,1718,1771,1436,2573,2471,102,2131,340,2596,1411,1185,130,777,153,35012,3767,585,150000,6067000400,254
06067009007,Sacramento,2484,779,155,1081,658,170,413,134,1213,1271,772,778,947,931,16,770,161,967,532,435,106,157,64,30173,2443,718,93800,6067009007,255
06067000300,Sacramento,3061,444,459,2563,7,124,311,52,1426,1635,992,1166,1813,1727,86,1500,227,1820,865,955,24,674,70,60500,3061,104,212600,6067000300,256
06067001000,Sacramento,609,5,99,464,59,0,40,19,471,138,397,108,217,207,10,137,70,190,130,60,20,32,0,10588,559,198,1000001,6067001000,257
06067005606,Sacramento,3974,744,612,3082,127,230,362,126,1785,2189,1246,1372,2015,1935,80,1594,341,2048,1018,1030,40,617,86,39391,3974,329,124800,6067005606,258
06067001100,Sacramento,920,15,82,611,152,69,88,0,520,400,474,349,521,506,15,329,177,513,294,219,16,229,58,21810,920,220,99200,6067001100,259
06067000200,Sacramento,3459,493,713,2881,21,124,327,100,1590,1869,1094,1159,1878,1835,43,1437,398,1908,1016,892,5,780,133,57566,3408,90,180400,6067000200,260
06067005508,Sacramento,3053,301,371,2256,187,215,251,104,1499,1554,1156,1225,1783,1725,58,1430,295,1804,957,847,31,695,104,41120,2964,372,102200,6067005508,261
06067000800,Sacramento,1471,68,631,1158,70,72,120,42,558,913,400,372,647,627,20,568,59,652,364,288,0,314,79,35652,1307,96,138800,6067000800,262
06067009107,Sacramento,3332,583,313,2274,233,325,346,134,1567,1765,1122,1314,1819,1751,68,1309,442,1854,935,919,68,538,76,54216,3253,156,133100,6067009107,263
06067005404,Sacramento,5542,708,1231,4479,75,425,338,183,2743,2799,1798,1805,2899,2719,180,2157,562,2927,1594,1333,13,1159,106,65708,5542,334,355700,6067005404,264
06113010506,Sacramento,2877,586,338,1987,55,265,441,82,1412,1465,928,1025,1414,1302,112,1023,279,1447,776,671,57,635,63,93915,2868,214,376000,6113010506,265
06067001400,Sacramento,2690,190,516,2032,123,41,352,71,1202,1488,1006,978,1489,1412,77,1142,270,1498,736,762,8,440,57,27774,2474,295,225000,6067001400,266
06067000900,Sacramento,323,92,26,143,22,0,144,0,210,113,113,92,172,166,6,148,18,172,90,82,12,54,8,36563,323,12,97500,6067000900,267
06067002100,Sacramento,2584,447,349,764,295,896,491,120,1351,1233,962,826,1028,968,60,790,178,1060,573,487,68,193,55,19375,2501,920,114300,6067002100,268
06067001200,Sacramento,2980,166,363,1813,309,256,458,112,1810,1170,1483,968,1657,1610,47,1268,342,1661,946,715,31,447,87,18341,2967,719,124600,6067001200,269
06067001500,Sacramento,4569,518,832,3847,77,124,393,83,2004,2565,1473,1746,2695,2596,99,2268,328,2703,1300,1403,43,1165,92,55169,4337,284,233300,6067001500,270
06067008800,Sacramento,520,161,0,346,33,0,75,0,286,234,215,144,113,113,0,49,64,113,56,57,0,68,0,8292,520,446,0,6067008800,271
06067009004,Sacramento,3999,1016,201,2037,693,532,523,166,2021,1978,1430,1352,1991,1958,33,1515,443,2007,1091,916,135,371,69,56714,3966,396,111500,6067009004,272
06067005403,Sacramento,2340,69,773,1959,5,222,120,11,1066,1274,701,797,1172,1105,67,942,163,1199,565,634,19,478,34,64489,2340,264,185900,6067005403,273
06067009106,Sacramento,4126,651,388,2943,263,322,426,119,2119,2007,1610,1477,2449,2365,84,1833,532,2468,1267,1201,99,814,176,44393,4087,433,133600,6067009106,274
06067001300,Sacramento,3186,163,101,2228,261,126,388,98,1724,1462,1606,1316,2358,2293,65,1992,301,2387,1288,1099,130,854,119,26560,3186,552,214300,6067001300,275
06067008909,Sacramento,2152,472,244,1359,166,234,214,103,1076,1076,675,761,1066,1009,57,706,303,1057,543,514,59,360,47,56515,2146,389,158600,6067008909,276
06067001600,Sacramento,4987,649,902,4213,69,48,387,173,2234,2753,1589,1847,2947,2887,60,2499,388,2972,1501,1471,0,975,103,52880,4910,320,192800,6067001600,277
06067002000,Sacramento,2685,366,437,763,203,1117,447,37,1320,1365,970,912,1260,1234,26,935,299,1277,682,595,107,243,61,22831,2685,578,98900,6067002000,278
06113010509,Sacramento,3529,528,232,2359,151,531,345,78,1642,1887,1259,1510,1887,1802,85,1414,388,1901,960,941,27,599,61,45104,3529,947,230700,6113010509,279
06067005201,Sacramento,2770,275,14,1267,303,435,573,146,1317,1453,1177,1304,1301,1273,28,955,318,1380,629,751,36,273,58,21058,1875,526,75000,6067005201,280
06067002200,Sacramento,4232,1292,538,1302,876,1122,756,131,1830,2402,1002,1400,1329,1296,33,968,328,1346,565,781,58,351,87,21077,4222,1617,161600,6067002200,281
06067001900,Sacramento,2898,295,239,1487,334,186,633,154,1457,1441,1187,1177,1590,1555,35,1268,287,1672,847,825,45,543,45,28152,2898,464,135900,6067001900,282
06067005202,Sacramento,3206,444,438,2197,111,295,436,138,1628,1578,1159,1165,1568,1501,67,1159,342,1594,804,790,29,483,63,42875,3199,579,149500,6067005202,283
06067009103,Sacramento,3235,826,348,1868,336,299,467,224,1622,1613,1074,987,1229,1186,43,832,354,1235,590,645,90,271,18,40519,2821,478,109500,6067009103,284
06113010605,Sacramento,2866,812,77,1727,20,556,280,136,1394,1472,937,1040,1448,1396,52,995,401,1464,739,725,20,679,143,80238,2861,330,240300,6113010605,285
06067009105,Sacramento,2815,568,236,1681,305,236,390,144,1371,1444,957,1054,1491,1442,49,1088,354,1537,732,805,66,352,59,46339,2797,479,114400,6067009105,286
06067001800,Sacramento,5316,1412,304,1974,977,754,1138,262,2677,2639,1872,1728,1867,1823,44,1410,413,1896,964,932,119,407,86,27694,5082,1723,118100,6067001800,287
06067009005,Sacramento,3258,744,289,1874,328,299,469,211,1633,1625,1086,1139,1455,1423,32,1108,315,1463,726,737,78,357,63,38047,3226,328,97200,6067009005,288
06113010606,Sacramento,7648,1727,567,5404,264,687,910,338,3973,3675,2691,2663,3866,3731,135,2798,933,3882,2001,1881,57,1472,245,52221,7548,959,177600,6113010606,289
06067001700,Sacramento,4853,781,968,3260,362,124,745,193,2213,2640,1495,1609,2399,2285,114,1995,290,2484,1197,1287,81,771,149,40469,4757,580,129600,6067001700,290
06113010300,Sacramento,6021,1534,532,4235,71,390,1044,269,2900,3121,1921,2034,3045,3002,43,2438,564,3079,1564,1515,109,805,156,57989,5998,411,146100,6113010300,291
06113010508,Sacramento,2630,486,266,2154,12,184,165,115,1128,1502,834,1044,1431,1338,93,985,353,1455,719,736,14,627,29,62537,2630,366,258300,6113010508,292
06113010507,Sacramento,8573,1678,325,5669,193,1404,781,460,4070,4503,2955,3615,4440,4271,169,3255,1016,4499,2016,2483,63,1638,219,42813,8557,2337,254000,6113010507,293
06113010703,Sacramento,6584,332,425,3598,153,2054,510,250,2997,3587,2602,3225,2656,2493,163,2161,332,2680,1288,1392,81,763,152,24363,4252,1805,251500,6113010703,294
06113010704,Sacramento,2200,283,354,1606,118,251,142,77,1104,1096,827,736,1077,1027,50,864,163,1095,610,485,29,352,41,51141,2195,472,271900,6113010704,295
06113010701,Sacramento,4549,476,404,3317,12,429,388,159,2219,2330,1823,1846,2558,2416,142,2013,403,2636,1352,1284,29,765,47,24208,4523,1421,278700,6113010701,296
06067009110,Sacramento,1615,412,65,636,508,105,229,114,722,893,495,643,724,717,7,447,270,729,338,391,36,123,39,26192,1584,448,47700,6067009110,297
06113010602,Sacramento,5177,496,483,3182,176,717,825,169,2489,2688,1993,2205,2896,2835,61,2232,603,2939,1424,1515,52,937,155,25803,4916,1709,195800,6113010602,298
06067002600,Sacramento,2721,510,184,1735,320,124,441,64,1284,1437,977,1050,1413,1360,53,1136,224,1418,714,704,6,489,68,37898,2716,540,178500,6067002600,299
06067005203,Sacramento,7140,981,1153,4823,445,576,942,269,3607,3533,2649,2357,3470,3371,99,2576,795,3540,1864,1676,106,958,128,41065,6664,802,141900,6067005203,300
06067002700,Sacramento,3921,1206,258,1005,1108,270,1201,292,1927,1994,1145,1312,1090,1034,56,695,339,1106,524,582,122,187,16,18766,3853,1500,80300,6067002700,301
06067002400,Sacramento,4419,747,765,3425,22,420,346,173,2018,2401,1366,1541,2419,2327,92,2097,230,2436,1195,1241,47,1161,146,72863,4419,221,262400,6067002400,302
06067009108,Sacramento,3684,803,442,2395,247,377,429,147,1732,1952,1183,1256,1797,1733,64,1223,510,1814,938,876,87,506,52,53012,3666,170,127100,6067009108,303
06113010608,Sacramento,4864,887,72,2580,39,1150,652,436,2276,2588,1809,2096,2542,2484,58,2076,408,2593,1283,1310,57,939,172,36771,4849,1663,200000,6113010608,304
06067009109,Sacramento,5096,1092,482,3276,384,553,558,325,2551,2545,1745,1777,2733,2553,180,1862,691,2766,1409,1357,85,737,211,60151,5082,394,132200,6067009109,305
06067002500,Sacramento,1659,294,215,1300,5,64,156,118,787,872,527,623,950,899,51,817,82,964,446,518,32,428,65,72019,1659,54,202700,6067002500,306
06067002300,Sacramento,3180,416,488,2453,32,276,330,77,1417,1763,1073,1203,1896,1796,100,1581,215,1907,911,996,83,764,105,52241,3164,198,186200,6067002300,307
06113010607,Sacramento,3650,786,286,2752,93,287,257,211,1749,1901,1233,1345,2105,2039,66,1554,485,2108,1097,1011,19,859,135,66827,3650,285,268000,6113010607,308
06067009112,Sacramento,3615,885,172,2086,297,455,462,284,1779,1836,1260,1298,1919,1838,81,1427,411,1939,941,998,101,372,49,43990,3592,344,110500,6067009112,309
06067009111,Sacramento,5585,1300,338,3068,380,784,862,406,2762,2823,1912,2035,2846,2768,78,2001,767,2892,1378,1514,115,647,115,39908,5563,700,122700,6067009111,310
06067002800,Sacramento,3510,1262,368,414,1227,510,1195,113,1662,1848,914,966,951,898,53,585,313,956,491,465,172,80,12,21645,3487,1306,70200,6067002800,311
06113010501,Sacramento,4521,482,13,2202,32,1375,523,377,2015,2506,1723,2303,1357,1237,120,1077,160,1406,621,785,6,476,61,21393,2077,575,218200,6113010501,312
06067002900,Sacramento,4789,907,789,3008,290,274,1081,100,2161,2628,1388,1705,2176,2140,36,1546,594,2225,1064,1161,100,485,126,35651,4789,712,110800,6067002900,313
06067003900,Sacramento,3649,660,997,1871,245,757,451,253,1712,1937,930,1062,1542,1480,62,1245,235,1561,757,804,64,582,50,46518,3600,330,175000,6067003900,314
06067003700,Sacramento,4651,1690,397,614,764,932,2062,216,2355,2296,1288,1276,1077,1041,36,695,346,1100,626,474,141,81,0,21174,4630,1921,71600,6067003700,315
06067003600,Sacramento,3054,965,289,924,221,490,1358,49,1467,1587,835,965,1052,1016,36,742,274,1090,598,492,74,159,23,28622,2980,680,84500,6067003600,316
06067003000,Sacramento,7008,1612,1094,3562,484,362,2133,399,3338,3670,2046,2256,2767,2744,23,2106,638,2822,1307,1515,157,481,74,36851,6995,1323,105800,6067003000,317
06067003501,Sacramento,2845,594,502,1218,336,404,661,195,1374,1471,847,902,1130,1079,51,821,258,1182,579,603,66,232,10,29229,2814,592,125100,6067003501,318
06067004402,Sacramento,4433,1560,333,822,772,870,1837,79,2153,2280,1216,1324,1023,1000,23,658,342,1082,599,483,115,85,19,23167,4417,1785,76700,6067004402,319
06067004401,Sacramento,4421,1271,576,1097,826,718,1605,115,2137,2284,1268,1306,1275,1248,27,916,332,1311,723,588,96,174,11,31699,4363,1264,84700,6067004401,320
06067003300,Sacramento,4128,608,1115,2557,113,907,377,133,1937,2191,1149,1256,1903,1822,81,1516,306,1934,954,980,96,706,126,52527,4109,272,164000,6067003300,321
06067009200,Sacramento,1442,268,168,835,8,165,311,123,799,643,571,435,718,675,43,502,173,718,413,305,43,112,10,50865,1432,74,206400,6067009200,322
06067003101,Sacramento,3670,1019,436,1519,243,150,1518,157,1813,1857,1116,1099,1522,1456,66,941,515,1520,825,695,111,145,34,40673,3658,510,80800,6067003101,323
06067003102,Sacramento,3295,925,386,1463,216,326,1173,98,1596,1699,955,1029,1142,1093,49,803,290,1175,539,636,96,145,12,30163,3289,651,82800,6067003102,324
06067003502,Sacramento,3125,590,625,1440,68,655,753,124,1461,1664,967,943,1406,1395,11,1064,331,1435,750,685,54,234,71,37766,3125,341,111400,6067003502,325
06067005103,Sacramento,700,189,198,335,55,96,156,58,347,353,180,133,238,238,0,132,106,246,149,97,14,45,7,32955,700,184,38800,6067005103,326
06067003201,Sacramento,8383,2701,665,1218,946,3444,2178,490,4065,4318,2342,2675,2299,2258,41,1488,770,2362,1290,1072,195,176,21,27717,8336,2267,88200,6067003201,327
06067003202,Sacramento,4778,1234,778,1635,206,1229,1290,348,2393,2385,1366,1400,1550,1525,25,1123,402,1588,880,708,104,189,26,28862,4670,1057,79000,6067003202,328
06067004601,Sacramento,7869,2491,681,2242,813,1281,3095,318,3953,3916,2355,2342,2625,2551,74,1678,873,2669,1518,1151,140,322,48,31622,7805,2014,84600,6067004601,329
06067004602,Sacramento,5364,1843,498,1395,651,759,2237,211,2616,2748,1444,1579,1389,1320,69,860,460,1448,851,597,144,192,58,27652,5359,1710,81900,6067004602,330
06067004500,Sacramento,8183,2712,840,1627,1133,1989,3013,280,4030,4153,2330,2301,2112,2031,81,1233,798,2168,1246,922,246,236,26,21148,8111,3490,81000,6067004500,331
06067004006,Sacramento,5184,1013,758,2003,952,1104,652,378,2509,2675,1593,1820,2507,2436,71,1819,617,2571,1194,1377,109,788,165,43155,5174,370,175500,6067004006,332
06067004001,Sacramento,6282,1106,1366,2568,786,1826,812,279,2999,3283,1807,2003,2792,2699,93,2007,692,2823,1440,1383,118,756,99,47917,6256,673,165100,6067004001,333
06067003400,Sacramento,4093,695,1170,1829,603,691,725,198,1887,2206,1038,1190,1585,1486,99,1156,330,1625,796,829,46,572,104,42848,4083,592,171800,6067003400,334
06067004100,Sacramento,5199,1526,664,915,729,1607,1522,221,2508,2691,1418,1591,1599,1599,0,1080,519,1650,819,831,154,209,34,24981,5071,1687,98100,6067004100,335
06067003800,Sacramento,5307,1464,844,1225,1883,593,1338,259,2498,2809,1399,1600,1879,1805,74,1129,676,1914,982,932,169,367,77,35724,5250,1106,97000,6067003800,336
06067004005,Sacramento,4333,613,994,2263,499,1010,391,81,1942,2391,1205,1521,2148,2069,79,1605,464,2138,1077,1061,42,827,114,55972,4178,180,212600,6067004005,337
06067004004,Sacramento,6649,1188,904,3376,572,1963,512,218,3219,3430,2110,2447,3795,3741,54,2663,1078,3860,1877,1983,121,1465,283,66988,6590,263,191500,6067004004,338
06067004801,Sacramento,5578,1615,641,1018,1242,2121,917,227,2785,2793,1621,1701,1564,1523,41,1031,492,1602,863,739,167,260,58,31545,5527,1492,81800,6067004801,339
06067004802,Sacramento,4422,1354,450,1580,663,744,1163,176,2115,2307,1246,1372,1626,1602,24,1016,586,1656,899,757,94,184,21,37049,4375,797,96200,6067004802,340
06067004009,Sacramento,5436,1112,390,2187,662,1742,706,134,2658,2778,1862,2072,3068,3000,68,2227,773,3140,1543,1597,69,1185,196,52000,5402,230,173200,6067004009,341
06067004008,Sacramento,3925,925,371,1788,315,1044,497,214,1851,2074,1212,1417,2164,2086,78,1419,667,2214,1095,1119,59,914,164,65133,3916,133,161000,6067004008,342
06067005002,Sacramento,6310,1876,1161,1985,1281,1453,1137,392,2870,3440,1513,1760,1695,1603,92,1094,509,1769,813,956,95,268,23,25498,6152,1712,89200,6067005002,343
06067005102,Sacramento,4514,1107,843,2316,438,718,682,247,2142,2372,1227,1337,1627,1614,13,1004,610,1653,826,827,138,234,33,36414,4429,655,84800,6067005102,344
06067004904,Sacramento,5570,1482,758,2408,1032,597,1237,243,2718,2852,1574,1756,2197,2111,86,1437,674,2286,1214,1072,101,369,52,41804,5527,714,107100,6067004904,345
06067004700,Sacramento,8093,2505,850,2130,1609,1544,2227,369,3856,4237,2218,2520,2630,2567,63,1752,815,2725,1467,1258,198,309,51,32463,8039,1926,94400,6067004700,346
06067005001,Sacramento,7982,2506,803,2193,1737,1689,1738,485,3874,4108,2232,2441,2590,2544,46,1568,976,2710,1400,1310,215,322,46,36716,7882,1756,102800,6067005001,347
06067004903,Sacramento,6896,2482,483,896,2580,1718,1264,343,3309,3587,1820,2111,1949,1889,60,1192,697,1997,899,1098,79,319,21,28687,6840,2116,95000,6067004903,348
06067005101,Sacramento,4239,1251,369,1490,675,821,784,427,2146,2093,1331,1288,1707,1671,36,1101,570,1755,971,784,130,354,28,36828,4228,895,98300,6067005101,349
06067004203,Sacramento,4861,1789,244,585,1109,943,1564,384,2202,2659,1298,1530,1463,1456,7,1018,438,1525,820,705,125,205,31,26835,4812,1636,84100,6067004203,350
06067004202,Sacramento,5842,1897,858,831,1777,1202,1472,484,2648,3194,1406,1681,1480,1447,33,858,589,1525,736,789,151,188,7,27134,5650,1660,88700,6067004202,351
06067004201,Sacramento,5722,1637,741,1250,1718,677,1550,380,2787,2935,1614,1730,1886,1845,41,1209,636,1932,970,962,204,328,29,39280,5690,957,89400,6067004201,352
06067009315,Sacramento,5540,1306,578,4158,120,384,617,180,2742,2798,1774,1882,2701,2550,151,1325,1225,2719,1424,1295,153,874,121,86710,5513,194,304100,6067009315,353
06067004011,Sacramento,2766,493,314,1061,213,1196,220,64,1379,1387,1004,955,1470,1428,42,1098,330,1487,788,699,17,755,119,78611,2766,161,387200,6067004011,354
06067004012,Sacramento,3315,822,289,1569,241,1020,297,188,1572,1743,1026,1178,1756,1696,60,1265,431,1805,924,881,91,804,154,69031,3305,52,285600,6067004012,355
06067004010,Sacramento,4671,945,434,1751,701,1328,610,264,2036,2635,1451,1841,2388,2340,48,1631,709,2444,1097,1347,73,890,154,49922,4550,327,167300,6067004010,356
06067004905,Sacramento,6980,2169,720,1734,1481,803,2609,277,3427,3553,1964,2127,2172,2132,40,1302,830,2262,1149,1113,94,350,81,31168,6906,1751,98000,6067004905,357
06067004906,Sacramento,2310,714,160,453,563,482,585,149,1132,1178,684,752,795,772,23,447,325,801,432,369,41,113,5,39349,2294,321,93200,6067004906,358
06067009316,Sacramento,3219,1017,79,1468,440,562,517,172,1576,1643,1025,1098,1364,1335,29,814,521,1405,681,724,111,300,45,51226,3208,311,112100,6067009316,359
06067009311,Sacramento,3597,1104,193,2188,105,657,325,322,1914,1683,1173,1127,1754,1734,20,897,837,1777,949,828,137,641,105,63621,3568,96,150000,6067009311,360
06067004300,Sacramento,7132,2548,472,997,1782,2095,1650,371,3461,3671,1957,2155,1953,1881,72,1239,642,1837,900,937,196,222,17,27669,7012,2735,82700,6067004300,361
06113010400,Sacramento,1301,334,159,670,0,39,592,0,661,640,423,385,607,584,23,354,230,652,413,239,14,92,14,43833,1292,184,214400,6113010400,362
06067009601,Sacramento,6856,2225,446,1061,1809,2178,1202,407,3314,3542,1999,2186,2277,2196,81,1420,776,2329,1190,1139,164,450,77,46652,6786,1482,107100,6067009601,363
06067009317,Sacramento,5834,1837,320,2874,559,1122,835,409,2782,3052,1735,1942,2648,2598,50,1465,1133,2747,1341,1406,77,669,58,65577,5761,126,156300,6067009317,364
06067009321,Sacramento,5256,1536,229,2008,586,1399,765,439,2504,2752,1662,1829,2542,2459,83,1385,1074,2596,1320,1276,62,919,171,67372,5221,170,139100,6067009321,365
06067009319,Sacramento,4666,1555,209,1438,443,1771,809,205,2222,2444,1412,1490,1782,1748,34,1016,732,1816,953,863,154,403,73,48836,4636,358,115900,6067009319,366
06067009318,Sacramento,2499,660,194,536,433,957,369,173,1287,1212,834,811,1023,990,33,590,400,1038,534,504,74,187,47,50383,2461,341,110400,6067009318,367
06067009606,Sacramento,7331,2161,631,1674,2044,1236,1885,372,3507,3824,2143,2396,2617,2587,30,1445,1142,2722,1390,1332,206,464,76,36351,7086,1472,111600,6067009606,368
06067009607,Sacramento,8412,2837,315,1488,2217,1749,2164,514,4081,4331,2538,2722,2901,2860,41,1516,1344,3106,1571,1535,285,424,66,35216,8400,1718,99500,6067009607,369
06067009605,Sacramento,467,67,79,259,0,35,161,12,286,181,195,126,210,199,11,131,68,216,150,66,0,53,0,35313,467,80,134000,6067009605,370
06067009404,Sacramento,4926,1146,553,3939,167,120,492,163,2460,2466,1555,1672,2301,2043,258,806,1237,2338,1244,1094,110,555,46,69087,4913,102,239800,6067009404,371
06067009320,Sacramento,4051,1291,156,1523,618,955,665,208,2020,2031,1246,1358,1773,1747,26,1023,724,1776,868,908,134,316,36,54728,4028,578,134300,6067009320,372
06067009312,Sacramento,3909,1136,231,2291,230,599,600,158,1820,2089,1154,1388,1976,1912,64,987,925,1985,970,1015,131,529,98,62076,3903,190,144600,6067009312,373
06067009313,Sacramento,892,233,63,529,34,85,166,78,406,486,257,339,440,429,11,219,210,453,192,261,26,131,43,60429,881,10,147200,6067009313,374
06067009610,Sacramento,6233,2042,251,1415,1305,1561,1183,544,3010,3223,1880,2060,2382,2302,80,1239,1063,2455,1208,1247,204,430,48,48224,6150,959,111100,6067009610,375
06067009608,Sacramento,2749,744,179,862,710,544,356,165,1292,1457,849,977,1315,1284,31,742,542,1343,640,703,118,336,79,50893,2729,330,140400,6067009608,376
06067009322,Sacramento,6865,2156,286,3002,779,1667,959,366,3392,3473,2203,2220,3470,3420,50,1857,1563,3525,1899,1626,186,956,182,68318,6725,85,169300,6067009322,377
06067009314,Sacramento,3067,854,158,1706,270,592,334,140,1545,1522,1041,1014,1528,1436,92,891,545,1580,826,754,72,456,151,67281,3034,70,185300,6067009314,378
06067009609,Sacramento,4543,1461,206,1122,1052,1304,728,224,2165,2378,1366,1510,1939,1906,33,875,1031,1996,995,1001,152,403,47,48657,4526,471,137400,6067009609,379
06067009614,Sacramento,5418,1564,197,2309,714,1217,711,446,2673,2745,1711,1946,2681,2641,40,1348,1293,2719,1299,1420,88,870,252,61010,5413,312,155600,6067009614,380
06067009613,Sacramento,1151,391,46,446,152,231,140,97,572,579,312,402,496,483,13,265,218,513,250,263,13,175,20,63583,1151,45,162500,6067009613,381
06067009323,Sacramento,3982,1227,221,2250,223,695,532,225,1954,2028,1290,1244,2001,1961,40,1129,832,2054,1112,942,82,754,110,84434,3974,142,224400,6067009323,382
06067009615,Sacramento,7717,2323,320,3840,820,1574,1153,224,3841,3876,2460,2614,3748,3654,94,1882,1772,3821,2008,1813,127,1352,269,67004,7641,418,156400,6067009615,383
06067009619,Sacramento,4581,1236,300,2206,439,1015,622,241,2089,2492,1427,1618,2305,2230,75,1172,1058,2361,1203,1158,39,893,166,72500,4537,193,181700,6067009619,384
06067009618,Sacramento,4112,1310,215,1717,478,1076,582,259,1950,2162,1241,1346,2024,1929,95,975,954,2060,1024,1036,33,684,109,60682,4098,208,162700,6067009618,385
06067009611,Sacramento,2936,985,97,1547,230,473,551,129,1454,1482,884,970,1385,1359,26,669,690,1408,704,704,48,446,113,60208,2936,118,153200,6067009611,386
06067009307,Sacramento,4822,1364,466,3803,151,114,485,167,2281,2541,1390,1602,2335,2254,81,1350,904,2374,1226,1148,88,803,98,61636,4679,230,188300,6067009307,387
06067009308,Sacramento,5929,1587,567,4327,190,29,902,359,2922,3007,1807,1968,2857,2747,110,1513,1234,2934,1548,1386,104,693,125,56690,5878,265,143700,6067009308,388
06067009612,Sacramento,3951,1146,179,1986,339,647,662,307,1917,2034,1200,1426,2254,2150,104,1075,1075,2305,1136,1169,34,803,111,72363,3931,100,165000,6067009612,389
06067009616,Sacramento,5572,1768,265,3725,369,437,680,291,2696,2876,1680,1859,2708,2608,100,1155,1453,2809,1443,1366,137,1027,137,67345,5532,74,152000,6067009616,390
06067009617,Sacramento,3749,1107,252,2305,248,586,405,197,1920,1829,1132,1258,1812,1704,108,855,849,1835,949,886,52,793,150,79943,3722,198,232200,6067009617,391
06067009403,Sacramento,1892,459,181,1561,0,0,294,0,967,925,615,637,854,777,77,409,368,871,485,386,36,183,33,62383,1883,170,269500,6067009403,392
06067009604,Sacramento,7157,1632,336,3756,882,794,1192,450,4063,3094,3121,2068,2840,2744,96,1376,1368,2930,1576,1354,33,1118,169,72302,6008,392,196900,6067009604,393
06067009309,Sacramento,2556,481,424,2118,49,126,145,81,1242,1314,794,857,1235,1180,55,653,527,1262,673,589,12,353,80,60368,2549,74,154100,6067009309,394
06067009310,Sacramento,7509,2054,484,5291,98,443,1046,546,3715,3794,2434,2537,3707,3615,92,1991,1624,3796,1955,1841,144,678,110,55987,7456,323,149700,6067009310,395
06067009406,Sacramento,1964,470,162,1722,15,68,145,0,1029,935,652,680,1025,867,158,337,530,1068,565,503,66,215,9,68594,1937,60,211000,6067009406,396
06067009501,Sacramento,2669,794,304,1200,5,50,1290,102,1227,1442,739,832,910,861,49,423,438,936,478,458,35,81,19,33214,2669,473,118300,6067009501,397
06067009700,Sacramento,2896,651,453,1318,0,203,1209,100,1570,1326,981,811,1306,1239,67,791,448,1335,806,529,55,159,19,40643,2867,295,179900,6067009700,398
06067009405,Sacramento,7381,2518,378,4721,192,238,1950,166,3663,3718,2204,2281,3189,2987,202,1281,1706,3248,1752,1496,272,614,81,54659,7304,435,142000,6067009405,399
06067009503,Sacramento,3123,654,548,1841,14,73,1068,122,1570,1553,988,933,1168,1143,25,749,394,1205,669,536,82,103,0,30977,3103,529,96300,6067009503,400
06067009502,Sacramento,6843,2008,600,4423,50,129,2007,216,3460,3383,2132,2103,2870,2805,65,1459,1346,2920,1659,1261,204,418,21,49384,6685,556,143200,6067009502,401
06067009504,Sacramento,1859,557,161,1126,32,80,568,30,877,982,563,578,759,745,14,475,270,772,444,328,56,73,12,33981,1849,391,119400,6067009504,402
06067009800,Sacramento,1934,287,372,1304,10,120,383,80,1010,924,689,586,794,748,46,404,344,795,468,327,29,111,5,34970,1932,218,99800,6067009800,403
