FIPS,MSA,TOT_POP,POP_16,POP_65,WHITE_,BLACK_,ASIAN_,HISP_,MULTI_RA,MALES,FEMALES,MALE1664,FEM1664,EMPL16,EMP_AWAY,EMP_HOME,EMP_29,EMP_30,EMP16_2,EMP_MALE,EMP_FEM,OCC_MAN,OCC_OFF1,OCC_INFO,HH_INC,POV_POP,POV_TOT,HSG_VAL,BLACK1,BLACK_R,PCTBLACK,PCTBLCK,polyid
55131430100,Milwaukee,5068,1248,429,5005,5,6,32,17,2610,2458,1763,1628,2817,2690,127,1852,838,2854,1563,1291,477,456,44,58295,5057,185,157200,5,2201,0.860631,0.000987,1
55089610100,Milwaukee,8003,1812,667,7720,35,36,129,59,3999,4004,2760,2764,4476,4237,239,2930,1307,4544,2386,2158,817,700,96,55124,7160,164,145900,35,26,0.005959,0.004373,2
55131410100,Milwaukee,4393,1026,534,4320,2,19,19,27,2198,2195,1446,1387,2389,2316,73,1636,680,2418,1306,1112,466,352,23,51769,4327,211,129800,2,97,0.030012,0.000455,3
55131400101,Milwaukee,7687,1801,703,7509,6,7,106,57,3943,3744,2652,2531,4296,4137,159,2637,1500,4358,2360,1998,736,896,61,62083,7682,224,162600,6,320,0.141892,0.000781,4
55131420104,Milwaukee,5086,1065,821,4957,64,0,11,0,2485,2601,1598,1602,2701,2632,69,1767,865,2787,1479,1308,423,510,48,51858,5086,160,156000,64,40,0.010384,0.012584,5
55131420102,Milwaukee,7619,1943,534,7253,0,143,103,15,3891,3728,2643,2499,4016,3898,118,2557,1341,4066,2187,1879,815,678,86,51844,7468,296,128800,0,2258,0.868852,0.000000,6
55089630201,Milwaukee,4831,1069,755,4726,0,46,2,41,2359,2472,1514,1493,2628,2553,75,1774,779,2653,1346,1307,341,551,54,61266,4735,125,142800,0,2269,0.873103,0.000000,7
55131400102,Milwaukee,3678,877,237,3601,0,0,47,11,1890,1788,1326,1238,2166,2123,43,1405,718,2181,1188,993,434,374,23,57532,3678,92,132800,0,18,0.004510,0.000000,8
55089620100,Milwaukee,5940,1472,516,5707,55,12,118,41,3069,2871,2015,1937,3470,3386,84,2301,1085,3543,1898,1645,623,647,59,55333,5922,175,146300,55,52,0.014111,0.009259,9
55131420400,Milwaukee,3485,710,689,3327,0,0,104,54,1660,1825,1056,1030,1788,1751,37,1319,432,1821,950,871,310,328,49,36231,3473,318,117200,0,635,0.270423,0.000000,10
55131420103,Milwaukee,6033,1283,1070,5892,0,51,71,19,2935,3098,1861,1819,3153,3081,72,1969,1112,3207,1737,1470,500,647,53,60019,5652,116,198400,0,50,0.012784,0.000000,11
55131420200,Milwaukee,5282,1109,1079,5169,0,10,47,47,2580,2702,1514,1580,2541,2457,84,1718,739,2594,1324,1270,425,555,37,53788,5268,151,142500,0,720,0.399645,0.000000,12
55131420300,Milwaukee,5368,1263,810,5126,40,38,132,32,2522,2846,1586,1709,2764,2731,33,1950,781,2810,1403,1407,575,441,70,46161,5144,411,122000,40,0,0.000000,0.007452,13
55089630202,Milwaukee,4536,1191,434,4329,39,7,52,74,2325,2211,1550,1361,2375,2323,52,1659,664,2380,1269,1111,350,501,24,53478,4307,205,142800,39,0,0.000000,0.008598,14
55089630100,Milwaukee,2731,561,401,2592,9,61,32,13,1299,1432,877,892,1526,1485,41,1072,413,1540,784,756,346,306,49,50193,2731,146,124800,9,0,0.000000,0.003295,15
55131440101,Milwaukee,7934,1887,1054,7552,45,29,207,101,3899,4035,2540,2453,4150,4063,87,2621,1442,4221,2332,1889,793,848,107,50203,7784,423,143800,45,0,0.000000,0.005672,16
55131440102,Milwaukee,6358,1563,513,6203,0,21,80,8,3279,3079,2233,2049,3534,3371,163,1766,1605,3601,2059,1542,472,859,57,73333,6354,191,196000,0,95,0.029315,0.000000,17
55131450102,Milwaukee,7383,1771,836,7115,32,27,90,78,3729,3654,2474,2302,4106,3908,198,2563,1345,4095,2184,1911,584,841,65,55934,7357,375,170200,32,898,0.515934,0.004334,18
55131450101,Milwaukee,8983,2262,848,8856,6,0,24,97,4472,4511,2926,2947,4997,4796,201,3292,1504,5077,2769,2308,883,1167,201,58313,8975,246,150500,6,17,0.004334,0.000668,19
55089640200,Milwaukee,6086,1390,625,5980,0,16,38,45,3133,2953,2032,2039,3256,3171,85,2121,1050,3329,1836,1493,286,978,77,70641,6086,230,175600,0,345,0.161692,0.000000,20
55089650300,Milwaukee,5000,1199,647,4911,17,7,37,12,2455,2545,1585,1569,2604,2406,198,1570,836,2681,1462,1219,205,757,62,78271,4800,134,217800,17,992,0.534442,0.003400,21
55089640100,Milwaukee,6246,1406,817,6006,16,0,179,25,3071,3175,1996,2027,3471,3407,64,2489,918,3518,1860,1658,471,624,95,46025,6246,143,140400,16,0,0.000000,0.002562,22
55131440200,Milwaukee,4225,1092,473,4040,0,0,116,7,2137,2088,1381,1279,2124,2036,88,1404,632,2206,1213,993,544,292,27,45142,4220,211,115400,0,73,0.021706,0.000000,23
55089650101,Milwaukee,5887,1591,587,5745,5,48,50,8,2886,3001,1847,1862,3178,3102,76,2011,1091,3188,1725,1463,232,1174,90,63125,5887,102,172200,5,1721,0.745981,0.000849,24
55089650102,Milwaukee,3013,655,552,2990,8,0,15,0,1441,1572,860,946,1497,1415,82,921,494,1489,781,708,120,447,49,57799,3000,114,184300,8,67,0.019855,0.002655,25
55089650200,Milwaukee,4743,1122,713,4665,8,32,32,6,2272,2471,1425,1483,2576,2513,63,1869,644,2647,1430,1217,236,796,99,52050,4743,53,175500,8,65,0.018889,0.001687,26
55131460101,Milwaukee,5572,1398,418,5451,67,12,5,17,2871,2701,1952,1804,2999,2892,107,1679,1213,3079,1649,1430,350,816,100,77038,5551,75,216500,67,35,0.008595,0.012024,27
55131470100,Milwaukee,4819,978,681,4657,68,7,35,18,2369,2450,1574,1586,2699,2577,122,1839,738,2755,1498,1257,234,620,77,61162,4751,92,159900,68,0,0.000000,0.014111,28
55089660200,Milwaukee,7818,1904,940,7328,190,183,92,25,3980,3838,2514,2460,3908,3792,116,2694,1098,3990,2200,1790,192,1412,94,76141,7743,215,218000,190,4048,0.990744,0.024303,29
55131460102,Milwaukee,4801,1031,414,4742,0,11,0,26,2456,2345,1705,1651,2849,2759,90,1898,861,2856,1553,1303,316,751,51,70510,4774,59,175000,0,31,0.007618,0.000000,30
55089660301,Milwaukee,5718,1326,680,5355,125,27,91,95,2927,2791,1876,1836,2990,2784,206,2003,781,3031,1704,1327,135,1128,109,92157,5710,85,239200,125,89,0.027694,0.021861,31
55089660100,Milwaukee,3254,592,673,3129,3,73,44,5,1499,1755,920,1069,1737,1688,49,1189,499,1778,860,918,114,506,35,55962,3254,89,164100,3,0,0.000000,0.000922,32
55131470201,Milwaukee,7092,1702,685,6658,151,103,173,0,3479,3613,2326,2379,3849,3762,87,2808,954,3945,2127,1818,424,1081,134,51671,7064,303,147400,151,127,0.045362,0.021292,33
55089660303,Milwaukee,5193,1241,962,4798,135,67,103,59,2462,2731,1449,1541,2324,2189,135,1598,591,2356,1345,1011,86,995,40,103336,5038,72,253800,135,1039,0.534750,0.025997,34
55089660304,Milwaukee,3318,928,434,3101,84,55,41,25,1561,1757,925,1031,1528,1468,60,1126,342,1536,864,672,60,627,25,134148,3318,26,374900,84,195,0.084777,0.025316,35
55131470202,Milwaukee,6627,1816,373,6290,114,20,70,66,3303,3324,2229,2209,3682,3535,147,2710,825,3756,1961,1795,413,937,146,69043,6617,65,171200,114,1934,0.787669,0.017202,36
55133204500,Milwaukee,7782,1666,777,7639,36,22,35,37,3970,3812,2738,2601,4377,4177,200,2382,1795,4484,2449,2035,401,1069,52,65604,7771,155,214100,36,22,0.005611,0.004626,37
55133203500,Milwaukee,5911,1516,588,5729,13,23,91,38,3028,2883,1933,1874,3175,3001,174,1852,1149,3193,1826,1367,188,938,49,83696,5901,69,260400,13,385,0.189189,0.002199,38
55133203406,Milwaukee,5585,1500,271,5514,0,16,49,6,2782,2803,1943,1871,3203,3143,60,2227,916,3224,1737,1487,372,911,138,77951,5585,152,186100,0,79,0.024182,0.000000,39
55079050102,Milwaukee,6182,1011,1294,4928,832,142,163,38,2704,3478,1850,2027,3099,3033,66,2311,722,3125,1521,1604,287,903,168,47033,5732,306,112100,832,115,0.039814,0.134584,40
55079050101,Milwaukee,5988,1120,982,4871,667,132,206,97,3003,2985,1928,1958,3256,3210,46,2492,718,3302,1670,1632,351,815,115,54167,5970,112,116700,667,8,0.002217,0.111389,41
55079000100,Milwaukee,8394,1729,2044,4307,3324,249,292,196,3612,4782,2089,2532,3381,3339,42,2353,986,3485,1659,1826,503,649,115,35584,8191,1636,81800,3324,1124,0.562618,0.395997,42
55079040100,Milwaukee,1631,338,240,1372,74,105,48,30,815,816,517,536,776,711,65,567,144,785,490,295,15,312,11,161292,1631,27,517300,74,140,0.052219,0.045371,43
55133200300,Milwaukee,3628,785,474,3475,68,36,33,12,1823,1805,1229,1140,1971,1884,87,1451,433,2021,1101,920,270,373,60,57708,3623,132,145500,68,648,0.283011,0.018743,44
55079000201,Milwaukee,4901,1686,434,1327,3076,102,226,118,2130,2771,1180,1601,1659,1638,21,1142,496,1737,736,1001,245,224,32,26909,4805,1602,45400,3076,92,0.027746,0.627627,45
55079030100,Milwaukee,4415,895,895,4070,132,47,69,41,2102,2313,1229,1396,1979,1911,68,1478,433,2029,1067,962,37,861,44,88026,4254,124,225600,132,0,0.000000,0.029898,46
55133200200,Milwaukee,7278,1423,1459,7040,69,37,43,89,3457,3821,2140,2256,3889,3773,116,2895,878,3911,2017,1894,263,1162,129,55924,7278,235,175100,69,5,0.000922,0.009481,47
55133200101,Milwaukee,4634,940,846,4499,26,7,71,31,2215,2419,1414,1434,2436,2372,64,1774,598,2484,1307,1177,235,614,84,50673,4514,109,142300,26,6,0.001500,0.005611,48
55133200103,Milwaukee,3368,715,571,3179,79,0,73,0,1653,1715,1028,1054,1701,1617,84,1341,276,1736,873,863,261,368,67,49043,3268,124,133200,79,117,0.040122,0.023456,49
55133200102,Milwaukee,5052,1025,879,4936,0,24,49,43,2376,2676,1479,1669,2710,2622,88,2062,560,2750,1312,1438,290,563,54,47024,5052,83,132300,0,43,0.011767,0.000000,50
55133203403,Milwaukee,4285,961,595,4234,0,14,32,5,2152,2133,1356,1373,2427,2317,110,1569,748,2438,1242,1196,306,621,104,64979,4273,63,163900,0,2306,0.879377,0.000000,51
55079000202,Milwaukee,5680,1455,274,3610,1536,145,171,190,2851,2829,1963,1988,3178,3143,35,2295,848,3248,1669,1579,461,668,124,53553,5624,413,106900,1536,748,0.403509,0.270423,52
55079035200,Milwaukee,4630,919,1029,4300,84,80,76,52,2192,2438,1280,1402,2298,2177,121,1696,481,2332,1226,1106,55,756,103,64973,4380,131,175200,84,942,0.529469,0.018143,53
55079035100,Milwaukee,2379,603,435,2255,10,75,28,11,1112,1267,622,719,1145,1042,103,805,237,1178,637,541,26,503,18,111477,2379,61,343500,10,3712,0.986706,0.004203,54
55079000700,Milwaukee,3534,817,550,1783,1426,0,128,132,1627,1907,920,1247,1552,1552,0,1136,416,1589,743,846,237,378,48,41466,3330,309,81500,1426,32,0.007957,0.403509,55
55079000900,Milwaukee,3713,1229,327,1177,2308,0,132,91,1627,2086,872,1285,1516,1478,38,1051,427,1576,664,912,228,185,21,31500,3693,707,80800,2308,12,0.003269,0.621600,56
55133203405,Milwaukee,2189,695,94,2159,2,7,4,5,1109,1080,701,699,1156,1101,55,762,339,1169,623,546,123,282,19,71008,2183,37,203200,2,5,0.000849,0.000914,57
55079060100,Milwaukee,7416,1248,1854,6436,530,196,139,115,3623,3793,2160,2154,3443,3318,125,2702,616,3480,1888,1592,163,1208,126,59032,7232,190,155900,530,0,0.000000,0.071467,58
55133204400,Milwaukee,2255,440,573,2233,0,0,16,0,1038,1217,628,614,966,893,73,502,391,970,585,385,80,333,19,65250,2017,47,278800,0,98,0.032269,0.000000,59
55079000800,Milwaukee,5086,1382,449,2269,2413,122,160,100,2453,2633,1505,1750,2448,2432,16,1768,664,2482,1251,1231,394,509,23,43821,5037,519,69600,2413,2462,0.896774,0.474440,60
55079000600,Milwaukee,6303,1605,1038,3056,2656,230,192,117,2852,3451,1729,1931,2705,2651,54,1914,737,2767,1466,1301,478,482,77,42813,5997,755,84700,2656,71,0.021604,0.421387,61
55079000304,Milwaukee,3262,781,396,2045,888,150,60,60,1630,1632,1014,1071,1639,1586,53,1185,401,1655,807,848,240,309,17,60182,3192,243,112400,888,8,0.002272,0.272226,62
55133200400,Milwaukee,4890,1297,563,4606,128,50,64,42,2419,2471,1508,1522,2441,2369,72,2000,369,2502,1359,1143,212,741,129,75702,4887,55,169700,128,399,0.196393,0.026176,63
55079000301,Milwaukee,1497,322,213,1111,294,0,47,22,635,862,441,521,867,833,34,662,171,890,421,469,133,220,21,61250,1497,21,96900,294,59,0.018143,0.196393,64
55079000302,Milwaukee,2504,993,76,678,1580,0,146,54,1129,1375,644,791,911,894,17,585,309,920,459,461,168,139,7,33393,2438,665,101700,1580,11,0.002808,0.630990,65
55133204300,Milwaukee,7919,1813,1199,7718,30,32,101,32,3835,4084,2498,2409,4132,3974,158,2756,1218,4154,2243,1911,411,903,59,53536,7809,163,155300,30,1536,0.698258,0.003788,66
55133203404,Milwaukee,3017,618,364,2844,0,10,98,53,1358,1659,980,1055,1613,1560,53,1147,413,1658,792,866,233,267,20,46667,3017,235,141300,0,1850,0.765957,0.000000,67
55133203402,Milwaukee,3991,1167,347,3831,18,23,77,42,2096,1895,1287,1190,2169,2097,72,1396,701,2217,1227,990,207,575,87,64365,3968,102,182900,18,2055,0.855288,0.004510,68
55079001100,Milwaukee,2980,1004,180,720,2174,28,27,31,1340,1640,744,1052,1145,1145,0,700,445,1180,435,745,177,93,12,26543,2980,680,51500,2174,190,0.080594,0.729530,69
55079001000,Milwaukee,3713,1074,286,1256,2089,124,150,78,1787,1926,1116,1237,1559,1548,11,1086,462,1607,735,872,295,283,8,32702,3653,481,55400,2089,502,0.209695,0.562618,70
55079070100,Milwaukee,4337,1216,496,4172,0,8,103,49,2078,2259,1253,1372,2312,2224,88,1873,351,2348,1222,1126,64,985,116,85539,4337,224,195700,0,0,0.000000,0.000000,71
55079001300,Milwaukee,3863,1253,347,1167,2269,209,70,102,1842,2021,1020,1243,1476,1430,46,1080,350,1540,683,857,273,223,84,33872,3816,759,54900,2269,84,0.026176,0.587367,72
55079001400,Milwaukee,2626,970,139,890,1510,77,59,90,1199,1427,665,852,967,954,13,718,236,1032,524,508,156,122,17,33657,2590,708,70000,1510,25,0.005841,0.575019,73
55079000303,Milwaukee,1836,442,127,1405,385,0,14,32,908,928,631,636,1010,984,26,781,203,1039,495,544,155,152,37,53438,1808,143,100500,385,18,0.004689,0.209695,74
55079001200,Milwaukee,3193,1441,98,439,2306,208,105,113,1460,1733,651,1003,792,775,17,557,218,818,354,464,165,46,3,21295,3185,1524,48600,2306,97,0.031764,0.722205,75
55079000502,Milwaukee,5175,1522,648,1926,2740,137,193,157,2486,2689,1465,1540,1862,1862,0,1476,386,1942,938,1004,378,281,25,37621,4620,899,79600,2740,74,0.022839,0.529469,76
55079070200,Milwaukee,5288,1620,516,5049,31,43,157,0,2585,2703,1548,1604,2511,2388,123,2012,376,2573,1518,1055,33,1086,60,111262,5275,75,275300,31,6,0.001556,0.005862,77
55079060200,Milwaukee,5946,1013,1477,5048,524,80,240,43,2712,3234,1681,1775,2928,2856,72,2249,607,2936,1455,1481,249,781,150,46849,5510,316,118300,524,117,0.040349,0.088126,78
55079001500,Milwaukee,3241,1065,240,708,1841,489,118,85,1534,1707,888,1048,1338,1330,8,965,365,1385,657,728,266,166,16,36366,3222,510,73200,1841,47,0.012564,0.568035,79
55133204200,Milwaukee,5152,1181,688,5020,0,15,63,14,2445,2707,1618,1665,2700,2660,40,1824,836,2726,1426,1300,335,584,49,51331,5039,90,140200,0,0,0.000000,0.000000,80
55079000501,Milwaukee,3411,885,304,2520,635,57,90,78,1572,1839,991,1231,1611,1611,0,1230,381,1663,808,855,245,310,58,41618,3393,315,92100,635,1643,0.733198,0.186162,81
55133203601,Milwaukee,4079,1050,280,3985,21,5,63,0,2008,2071,1371,1378,2382,2279,103,1726,553,2409,1285,1124,257,504,77,54081,4079,121,180200,21,48,0.012584,0.005148,82
55133203301,Milwaukee,6488,1542,646,6273,0,33,53,44,3140,3348,2086,2214,3727,3637,90,2698,939,3762,1960,1802,313,981,113,66033,6486,96,178500,0,128,0.045371,0.000000,83
55079001600,Milwaukee,2715,722,338,1140,1366,39,106,56,1236,1479,748,907,1157,1136,21,732,404,1173,568,605,141,165,21,32917,2642,400,66600,1366,3127,0.961806,0.503131,84
55079001800,Milwaukee,3239,1119,256,856,2055,0,120,196,1366,1873,703,1161,1289,1282,7,832,450,1305,518,787,216,173,6,29073,3226,877,57000,2055,74,0.022587,0.634455,85
55079001900,Milwaukee,3655,1222,221,956,2341,114,42,111,1587,2068,854,1358,1297,1289,8,935,354,1335,550,785,305,131,0,26834,3582,914,51900,2341,52,0.014477,0.640492,86
55079002000,Milwaukee,2469,757,242,639,1724,21,24,61,1129,1340,647,823,837,819,18,507,312,845,375,470,138,115,6,25898,2438,606,46700,1724,0,0.000000,0.698258,87
55079000400,Milwaukee,2431,625,243,1381,806,5,164,75,1124,1307,711,852,1177,1159,18,907,252,1189,563,626,171,160,23,32681,2406,249,78200,806,114,0.039623,0.331551,88
55079002200,Milwaukee,1909,649,220,879,942,0,64,18,1002,907,487,553,735,730,5,517,213,735,324,411,118,71,0,30944,1889,294,60800,942,17,0.004373,0.493452,89
55079002100,Milwaukee,2837,930,184,520,2044,0,123,91,1300,1537,762,961,1025,1019,6,728,291,1076,477,599,234,88,7,27823,2837,892,47900,2044,125,0.044655,0.720479,90
55133200500,Milwaukee,4770,1319,469,4471,189,57,4,40,2339,2431,1458,1524,2463,2414,49,1834,580,2500,1366,1134,202,857,126,81539,4770,30,195300,189,9,0.002411,0.039623,91
55133200600,Milwaukee,1881,320,448,1824,0,25,10,8,878,1003,563,550,949,923,26,772,151,985,525,460,136,151,28,38333,1866,45,114800,0,79,0.024223,0.000000,92
55079002300,Milwaukee,4626,1335,485,286,4068,7,152,79,2061,2565,1221,1585,1595,1595,0,1199,396,1657,693,964,251,168,0,28856,4608,1067,48100,4068,132,0.047011,0.879377,93
55079001700,Milwaukee,4598,1408,511,1978,2201,139,137,89,2111,2487,1215,1464,1930,1866,64,1400,466,1959,867,1092,292,257,52,35679,4577,650,69300,2201,638,0.272226,0.478686,94
55079003000,Milwaukee,3776,982,430,1443,2001,76,142,97,1698,2078,1021,1343,1736,1696,40,1273,423,1768,794,974,265,215,12,38000,3704,455,61100,2001,7,0.002188,0.529926,95
55079070300,Milwaukee,4538,952,658,4112,83,211,98,28,2103,2435,1372,1556,2397,2356,41,1881,475,2427,1261,1166,100,836,93,54103,4519,156,142700,83,39,0.009551,0.018290,96
55079002900,Milwaukee,2144,598,249,725,1096,103,145,75,994,1150,614,683,855,855,0,640,215,853,423,430,154,94,22,34225,2113,536,50900,1096,13,0.003295,0.511194,97
55079002800,Milwaukee,2438,846,155,354,1850,7,102,96,1099,1339,595,842,734,725,9,540,185,754,322,432,124,39,13,28276,2424,586,48900,1850,1382,0.630990,0.758819,98
55079002500,Milwaukee,2314,848,128,313,1812,16,60,113,1062,1252,571,767,816,805,11,614,191,861,369,492,132,104,12,27008,2284,574,47700,1812,27,0.006257,0.783060,99
55079002400,Milwaukee,2417,711,143,155,2258,0,0,0,1122,1295,689,874,924,911,13,624,287,962,370,592,152,102,0,26767,2414,521,43000,2258,45,0.012024,0.934216,100
55133200801,Milwaukee,5450,1588,321,5106,47,148,72,77,2695,2755,1737,1804,2780,2667,113,2077,590,2808,1581,1227,135,934,108,95535,5450,83,210400,47,4068,0.993763,0.008624,101
55133203602,Milwaukee,5477,1613,380,5216,0,124,88,43,2655,2822,1734,1750,2959,2892,67,2182,710,2979,1625,1354,235,790,138,70150,5469,85,168900,0,82,0.024786,0.000000,102
55133204100,Milwaukee,4341,979,460,4139,32,49,60,55,2192,2149,1507,1395,2248,2124,124,1273,851,2285,1252,1033,174,571,37,75418,4252,139,256400,32,1261,0.588325,0.007372,103
55133203701,Milwaukee,7180,1885,669,6996,7,53,16,55,3588,3592,2285,2341,3874,3681,193,2324,1357,3911,2090,1821,313,1219,59,73189,7169,265,234500,7,0,0.000000,0.000975,104
55079003300,Milwaukee,4923,1235,695,2421,1969,176,156,158,2201,2722,1367,1626,2139,2106,33,1592,514,2201,1031,1170,393,357,45,37917,4857,544,85400,1969,1161,0.569277,0.399959,105
55079003200,Milwaukee,2832,820,364,1087,1298,336,17,94,1328,1504,761,887,1181,1157,24,876,281,1210,583,627,226,252,40,44014,2795,240,74500,1298,76,0.023456,0.458333,106
55079004400,Milwaukee,3038,774,230,628,2246,11,88,65,1394,1644,943,1091,1269,1263,6,842,421,1293,625,668,192,320,29,23529,3007,913,38000,2246,228,0.091697,0.739302,107
55079003100,Milwaukee,3620,1100,310,876,2201,398,83,5,1629,1991,958,1252,1534,1520,14,1158,362,1575,704,871,241,132,23,37577,3581,354,61500,2201,1413,0.640492,0.608011,108
55079002700,Milwaukee,2038,677,158,377,1544,0,33,7,953,1085,544,659,813,805,8,532,273,843,376,467,197,69,10,35221,1979,448,53400,1544,2089,0.856894,0.757605,109
55133200802,Milwaukee,8092,1829,1563,7606,41,265,54,50,3731,4361,2231,2469,3862,3772,90,3058,714,3934,2037,1897,357,1272,142,70859,8092,147,188300,41,30,0.007475,0.005067,110
55079002600,Milwaukee,3179,1070,146,317,2504,104,178,58,1409,1770,816,1147,1055,1050,5,689,361,1108,424,684,141,111,0,27917,3093,915,46300,2504,2946,0.952773,0.787669,111
55133200700,Milwaukee,4096,900,755,3826,39,107,86,38,2047,2049,1262,1179,2006,1937,69,1553,384,2049,1138,911,235,607,91,65000,4096,162,160900,39,16,0.003865,0.009521,112
55079090100,Milwaukee,4439,903,1297,4157,141,49,82,10,1953,2486,1116,1123,1880,1834,46,1524,310,1966,979,987,185,457,115,43949,4430,227,123900,141,0,0.000000,0.031764,113
55079004300,Milwaukee,5514,1313,700,162,5199,31,97,17,2461,3053,1506,1995,2066,2027,39,1395,632,2140,832,1308,254,312,18,31678,5507,1016,52900,5199,2341,0.884211,0.942873,114
55079004100,Milwaukee,2774,747,275,229,2453,29,28,26,1181,1593,713,1039,1091,1066,25,755,311,1103,413,690,146,135,7,26402,2749,626,56300,2453,332,0.149378,0.884283,115
55079004200,Milwaukee,3171,921,285,85,2971,23,40,25,1403,1768,844,1121,1040,1040,0,596,444,1060,446,614,207,135,10,26927,3101,883,44200,2971,186,0.071467,0.936928,116
55079080100,Milwaukee,2759,469,303,2476,27,88,92,64,1332,1427,961,1026,1675,1581,94,1279,302,1680,818,862,68,583,138,51801,2756,60,167500,27,225,0.087791,0.009786,117
55079080200,Milwaukee,3381,624,352,3069,69,51,149,38,1568,1813,1112,1293,1977,1935,42,1494,441,2002,979,1023,69,664,118,41969,3381,300,156500,69,2453,0.892144,0.020408,118
55079080300,Milwaukee,3962,975,363,3593,86,40,159,77,1904,2058,1256,1368,2122,1961,161,1592,369,2158,1132,1026,60,973,102,82648,3962,56,234500,86,0,0.000000,0.021706,119
55079003400,Milwaukee,5251,905,1200,3871,1052,63,170,95,2436,2815,1436,1710,2621,2535,86,2067,468,2688,1249,1439,294,598,68,35245,5236,466,89300,1052,1256,0.587367,0.200343,120
55079003600,Milwaukee,1858,493,186,387,1413,5,40,7,864,994,542,637,786,781,5,541,240,817,400,417,131,123,0,32299,1850,215,63800,1413,1538,0.709881,0.760495,121
55079003500,Milwaukee,3423,874,487,1139,1934,101,176,51,1642,1781,956,1106,1407,1362,45,1011,351,1423,645,778,174,128,6,38708,3368,371,72600,1934,51,0.013424,0.565001,122
55079004000,Milwaukee,2662,1026,136,229,2291,42,34,31,1131,1531,550,950,744,731,13,439,292,779,330,449,92,109,5,18443,2626,1216,53600,2291,368,0.186162,0.860631,123
55133203200,Milwaukee,4114,863,380,4014,9,0,28,38,2114,2000,1464,1407,2218,2156,62,1537,619,2227,1273,954,146,722,76,74278,4114,74,270400,9,8,0.002199,0.002188,124
55133200902,Milwaukee,4224,1002,723,4001,54,124,21,24,2070,2154,1194,1305,2003,1896,107,1584,312,2047,1091,956,83,738,65,83820,4224,103,195200,54,2504,0.919436,0.012784,125
55079005100,Milwaukee,3482,978,444,1310,1862,21,101,178,1596,1886,947,1113,1395,1384,11,1128,256,1467,748,719,154,193,12,30541,3456,481,70400,1862,16,0.004097,0.534750,126
55079003800,Milwaukee,2509,696,170,228,2209,0,47,19,1047,1462,663,980,1140,1092,48,831,261,1156,445,711,172,204,20,42546,2481,251,71600,2209,0,0.000000,0.880430,127
55079005200,Milwaukee,1563,312,348,1140,314,11,55,7,644,919,387,516,714,694,20,570,124,722,329,393,89,129,12,37827,1563,106,78200,314,675,0.324843,0.200896,128
55079003900,Milwaukee,2850,822,200,195,2520,4,19,107,1268,1582,751,1077,1237,1220,17,941,279,1258,512,746,198,144,10,30000,2825,400,54000,2520,419,0.198861,0.884211,129
55079004700,Milwaukee,4408,1284,448,96,4048,56,5,94,1987,2421,1132,1544,1272,1239,33,823,416,1350,519,831,184,83,5,22013,4332,1303,38100,4048,147,0.054749,0.918330,130
55079005400,Milwaukee,3616,669,948,3141,203,57,71,106,1624,1992,947,1052,1583,1539,44,1243,296,1669,802,867,235,287,24,35571,3431,218,83200,203,667,0.311628,0.056139,131
55079005500,Milwaukee,3232,622,739,2966,97,39,60,26,1453,1779,904,967,1619,1605,14,1288,317,1617,828,789,153,349,42,46189,3219,101,95300,97,29,0.007257,0.030012,132
55133200901,Milwaukee,4140,851,954,3941,16,105,15,25,1968,2172,1148,1187,1871,1788,83,1556,232,1890,1024,866,171,580,50,69375,4032,83,177300,16,149,0.055503,0.003865,133
55079090200,Milwaukee,1934,292,530,1738,77,0,81,38,925,1009,534,578,1018,1000,18,831,169,1018,532,486,49,314,56,61181,1934,21,141200,77,54,0.015441,0.039814,134
55079004600,Milwaukee,3282,1144,338,10,3127,104,6,35,1439,1843,801,999,938,892,46,566,326,963,428,535,163,29,7,24144,3245,1196,41500,3127,168,0.057527,0.952773,135
55079004500,Milwaukee,2839,795,292,55,2670,30,28,56,1294,1545,747,1005,983,927,56,666,261,1018,447,571,110,82,0,24963,2762,848,39600,2670,99,0.034144,0.940472,136
55079080400,Milwaukee,3661,406,969,3164,125,191,83,87,1560,2101,1023,1263,1850,1795,55,1415,380,1869,809,1060,65,528,68,31964,3493,488,132000,125,79,0.024303,0.034144,137
55079003700,Milwaukee,2466,700,246,653,1705,9,56,19,1133,1333,689,831,1105,1097,8,835,262,1153,539,614,163,181,0,38225,2448,96,72300,1705,1969,0.809489,0.691403,138
55133203302,Milwaukee,8733,1576,1171,8355,25,87,182,71,4297,4436,2967,3019,5026,4886,140,3594,1292,5047,2693,2354,373,1639,221,58869,8452,208,160400,25,80,0.024675,0.002863,139
55079006500,Milwaukee,2918,1073,226,45,2800,32,13,16,1273,1645,633,986,750,743,7,504,239,764,285,479,107,94,0,22214,2899,1157,31400,2800,0,0.000000,0.959561,140
55079005300,Milwaukee,1962,415,267,1751,89,0,97,25,997,965,667,613,1042,1042,0,882,160,1053,572,481,117,258,9,47609,1962,107,83300,89,2520,0.936313,0.045362,141
55079004800,Milwaukee,4394,1411,253,231,4040,0,91,26,2029,2365,1182,1548,1394,1321,73,936,385,1433,596,837,198,191,7,27817,4347,1228,44100,4040,42,0.011721,0.919436,142
55079005000,Milwaukee,4917,1406,330,2110,2509,6,176,116,2302,2615,1374,1807,2312,2276,36,1667,609,2360,1048,1312,262,396,23,36707,4882,556,77300,2509,18,0.004889,0.510270,143
55079004900,Milwaukee,4976,1533,260,1016,3712,66,57,114,2187,2789,1312,1871,2006,1976,30,1463,513,2062,831,1231,228,420,33,35455,4886,872,77900,3712,14,0.003736,0.745981,144
55079006600,Milwaukee,3668,1250,398,80,3491,0,44,5,1691,1977,896,1124,790,784,6,470,314,803,345,458,108,77,0,17321,3647,1479,28800,3491,109,0.037398,0.951745,145
55079006900,Milwaukee,2573,917,188,120,2123,7,271,27,1155,1418,649,819,623,609,14,335,274,629,255,374,89,69,5,20250,2532,1168,39000,2123,466,0.200343,0.825107,146
55079007200,Milwaukee,2807,489,242,1649,574,54,384,141,1386,1421,1053,1023,1585,1572,13,1261,311,1618,815,803,89,314,48,34750,2785,419,78600,574,75,0.022862,0.204489,147
55079007400,Milwaukee,3306,238,128,2998,138,23,102,29,1548,1758,1370,1570,1754,1696,58,1478,218,1820,790,1030,42,379,59,85000,1459,201,268100,138,67,0.019888,0.041742,148
55079007300,Milwaukee,2459,120,185,2169,46,126,74,37,1239,1220,1114,1040,1761,1741,20,1363,378,1780,897,883,40,509,144,40788,2389,495,149600,46,82,0.025316,0.018707,149
55079006800,Milwaukee,3047,1027,353,54,2879,48,16,7,1407,1640,751,916,712,697,15,472,225,744,292,452,115,80,0,22955,3002,1146,30000,2879,0,0.000000,0.944864,150
55079006300,Milwaukee,3095,1156,210,49,2921,7,56,22,1442,1653,756,973,796,769,27,444,325,814,342,472,114,54,19,20448,3010,1369,35600,2921,9,0.002562,0.943780,151
55079006700,Milwaukee,1639,614,170,35,1542,20,23,19,687,952,276,579,364,364,0,193,171,378,94,284,59,20,0,15597,1628,677,32100,1542,766,0.453133,0.940818,152
55079005800,Milwaukee,3291,656,400,2741,279,0,186,61,1481,1810,1001,1234,1981,1935,46,1593,342,2000,873,1127,156,419,48,41117,3275,157,101300,279,21,0.005345,0.084777,153
55079007000,Milwaukee,3393,1313,276,148,2931,52,216,39,1544,1849,739,1065,867,848,19,647,201,897,421,476,168,82,6,18953,3364,1482,33400,2931,0,0.000455,0.863837,154
55079006400,Milwaukee,3006,1126,207,18,2885,0,34,63,1357,1649,734,939,633,633,0,394,239,647,242,405,125,81,0,20481,2938,1166,27800,2885,254,0.093243,0.959747,155
55079007100,Milwaukee,2033,616,122,1086,466,7,394,67,969,1064,590,705,905,884,21,655,229,927,444,483,96,165,22,29479,2033,477,58300,466,46,0.012418,0.229218,156
55079005700,Milwaukee,2330,400,372,2094,79,0,122,18,979,1351,662,896,1362,1342,20,1151,191,1383,617,766,93,291,17,38915,2323,72,96200,79,1383,0.634455,0.033906,157
55079005600,Milwaukee,2135,398,432,2031,37,33,34,0,856,1279,531,774,1105,1054,51,888,166,1115,498,617,86,293,37,50477,1979,53,107900,37,0,0.000000,0.017330,158
55079090300,Milwaukee,3460,627,704,3031,96,209,63,56,1550,1910,1009,1120,1711,1658,53,1411,247,1767,887,880,51,565,81,45729,3460,206,155900,96,388,0.194812,0.027746,159
55079007800,Milwaukee,3427,221,244,3060,74,123,74,49,1730,1697,1519,1443,2327,2262,65,1855,407,2415,1203,1212,84,654,85,32944,3383,1036,158300,74,44,0.011945,0.021593,160
55079007500,Milwaukee,2620,391,163,2456,99,34,9,7,1319,1301,1071,995,1690,1589,101,1257,332,1695,908,787,49,591,69,74861,2616,232,229300,99,746,0.401257,0.037786,161
55079010900,Milwaukee,5630,139,1331,4868,332,205,132,69,2744,2886,2301,1859,3533,3431,102,2776,655,3598,2008,1590,65,1366,112,39571,4979,502,132300,332,7,0.002066,0.058970,162
55079005900,Milwaukee,3798,1188,251,1481,1721,236,250,79,1821,1977,1090,1269,1736,1692,44,1255,437,1772,907,865,283,304,35,40675,3752,673,71100,1721,1510,0.693162,0.453133,163
55079006000,Milwaukee,2880,1115,79,298,2506,13,25,32,1254,1626,690,996,1047,1041,6,677,364,1085,432,653,117,165,20,31614,2837,684,69100,2506,0,0.000000,0.870139,164
55079006100,Milwaukee,2761,1006,152,271,2235,0,69,147,1227,1534,685,918,989,935,54,675,260,1002,390,612,126,162,12,32908,2689,556,84400,2235,32,0.007972,0.809489,165
55079006200,Milwaukee,3438,1252,314,254,2946,39,9,67,1510,1928,718,1154,983,976,7,592,384,1053,404,649,164,85,7,24665,3264,1142,43600,2946,16,0.004168,0.856894,166
55079008900,Milwaukee,1732,757,89,51,1643,0,23,15,888,844,388,498,388,363,25,178,185,405,149,256,46,16,0,18242,1704,733,47300,1643,2,0.000668,0.948614,167
55079008800,Milwaukee,2485,1014,135,0,2462,6,0,12,1021,1464,562,774,637,630,7,369,261,646,279,367,114,48,0,19653,2471,1166,35500,2462,138,0.051173,0.990744,168
55079008700,Milwaukee,1809,737,134,7,1786,0,16,0,857,952,387,551,384,377,7,216,161,403,179,224,66,46,0,19000,1800,894,43400,1786,135,0.050523,0.987286,169
55079008600,Milwaukee,1644,616,125,44,1600,0,0,0,741,903,383,520,366,348,18,153,195,377,163,214,56,21,0,17538,1644,762,24700,1600,179,0.066449,0.973236,170
55079008500,Milwaukee,1728,657,225,66,1662,0,0,0,765,963,363,483,373,373,0,174,199,394,215,179,51,43,0,18261,1657,769,26900,1662,2921,0.948614,0.961806,171
55079008400,Milwaukee,1452,593,113,166,1256,0,30,0,696,756,312,434,353,328,25,129,199,353,171,182,36,23,0,14797,1452,590,31700,1256,170,0.058725,0.865014,172
55079008300,Milwaukee,1354,442,187,7,1336,0,11,0,590,764,323,402,320,280,40,123,157,320,169,151,77,12,0,16895,1341,574,29900,1336,10,0.002709,0.986706,173
55079008200,Milwaukee,1340,605,38,108,1153,14,32,16,572,768,254,443,282,268,14,156,112,293,127,166,39,57,0,17917,1256,788,52000,1153,0,0.000000,0.860448,174
55079008100,Milwaukee,1587,534,106,88,1134,49,273,8,747,840,419,528,420,388,32,257,131,426,168,258,45,36,1,17375,1587,711,37200,1134,2413,0.884283,0.714556,175
55079008000,Milwaukee,2173,503,166,929,502,22,574,86,1068,1105,750,754,1016,978,38,730,248,1039,534,505,110,152,28,25909,2169,698,47000,502,126,0.044908,0.231017,176
55079007900,Milwaukee,1889,350,98,1251,368,14,177,44,912,977,743,698,988,982,6,751,231,1002,486,516,54,181,11,30500,1889,448,57500,368,142,0.053203,0.194812,177
55079007600,Milwaukee,3343,186,578,2984,98,152,38,67,1551,1792,1301,1278,2202,2126,76,1638,488,2252,1163,1089,62,790,115,40634,3176,425,196000,98,0,0.000000,0.029315,178
55079091000,Milwaukee,4527,992,392,4203,79,67,127,7,2143,2384,1507,1636,2600,2487,113,1993,494,2625,1275,1350,98,804,73,51279,4518,265,121400,79,69,0.021469,0.017451,179
55079090900,Milwaukee,4067,910,685,3726,108,26,118,52,1816,2251,1169,1303,2109,2007,102,1730,277,2109,1027,1082,99,595,55,47647,3735,156,118000,108,11,0.002764,0.026555,180
55079007700,Milwaukee,3716,183,196,3103,146,149,162,80,1906,1810,1739,1598,2767,2689,78,2178,511,2784,1456,1328,148,759,227,31506,3698,572,115400,146,2495,0.918330,0.039290,181
55079090800,Milwaukee,2477,561,331,2375,0,58,44,0,1111,1366,692,893,1415,1374,41,1215,159,1438,665,773,62,541,33,60729,2477,46,164400,0,0,0.000000,0.000000,182
55079090700,Milwaukee,3170,766,488,3058,20,5,28,31,1529,1641,946,970,1567,1500,67,1299,201,1571,823,748,33,576,53,76926,3170,74,178500,20,96,0.029898,0.006309,183
55079009900,Milwaukee,1617,585,91,80,1383,55,67,25,763,854,414,527,340,334,6,218,116,357,137,220,70,9,0,16920,1602,841,25100,1383,0,0.000000,0.855288,184
55079009300,Milwaukee,2552,675,149,1467,829,5,78,158,1223,1329,812,916,1332,1304,28,1069,235,1346,648,698,86,301,35,40250,2550,336,82300,829,2235,0.865014,0.324843,185
55079009200,Milwaukee,1909,695,68,362,1161,167,109,85,871,1038,523,623,751,726,25,563,163,752,304,448,103,102,0,39083,1828,474,67200,1161,1052,0.542403,0.608172,186
55079009100,Milwaukee,2901,1157,102,212,2495,62,87,25,1325,1576,689,953,981,966,15,634,332,1011,393,618,118,92,0,24784,2869,1276,57300,2495,128,0.045500,0.860048,187
55079009000,Milwaukee,3106,1447,93,103,2771,88,48,96,1317,1789,603,963,653,653,0,441,212,721,293,428,62,95,9,18333,3054,1612,44400,2771,69,0.021593,0.892144,188
55079009800,Milwaukee,1679,773,52,36,1245,189,22,181,801,878,372,482,361,335,26,176,159,370,154,216,76,16,0,17469,1657,705,36500,1245,29,0.007372,0.741513,189
55079010000,Milwaukee,895,393,54,41,838,0,0,16,337,558,165,283,192,192,0,133,59,192,95,97,34,13,4,15192,885,483,26800,838,134,0.049895,0.936313,190
55079010100,Milwaukee,1144,474,37,24,992,29,45,47,539,605,258,375,237,237,0,113,124,256,96,160,54,23,0,20045,1137,418,51200,992,2800,0.943780,0.867133,191
55079010200,Milwaukee,854,248,102,66,742,32,14,0,431,423,268,236,213,213,0,137,76,222,89,133,25,25,4,11979,846,395,25800,742,2740,0.940818,0.868852,192
55079010300,Milwaukee,789,198,85,14,746,0,4,25,363,426,200,306,190,190,0,131,59,205,90,115,6,30,10,20345,789,275,33600,746,189,0.075380,0.945501,193
55079010400,Milwaukee,846,364,110,30,790,0,8,0,324,522,159,213,177,177,0,107,70,185,79,106,11,26,0,18929,820,445,48800,790,21,0.005413,0.933806,194
55079010500,Milwaukee,1206,390,143,88,1039,0,39,12,478,728,274,399,332,326,6,250,76,338,117,221,39,59,7,19042,1194,498,68200,1039,125,0.042077,0.861526,195
55079010600,Milwaukee,1225,403,155,116,748,0,361,0,587,638,320,347,354,354,0,274,80,346,181,165,85,21,0,25938,1221,327,49600,748,2174,0.860448,0.610612,196
55079010700,Milwaukee,1981,471,89,785,766,0,355,59,1038,943,736,685,959,959,0,740,219,995,512,483,98,166,18,26325,1970,714,46000,766,574,0.231017,0.386673,197
55133201202,Milwaukee,5619,1208,990,5195,42,265,47,70,2704,2915,1705,1716,2679,2586,93,2064,522,2712,1535,1177,104,1084,141,88403,5551,83,248700,42,110,0.037786,0.007475,198
55133201201,Milwaukee,2311,618,243,2050,64,126,34,37,1131,1180,702,748,1150,1101,49,785,316,1171,694,477,36,509,35,91330,2200,36,243000,64,41,0.010983,0.027694,199
55133201101,Milwaukee,4607,1079,737,4302,54,182,31,20,2237,2370,1352,1439,2314,2189,125,1825,364,2355,1270,1085,84,741,124,72529,4607,72,184400,54,2971,0.959561,0.011721,200
55133201000,Milwaukee,6369,1388,1416,6143,11,65,105,45,2999,3370,1749,1816,2653,2476,177,2123,353,2692,1609,1083,101,1124,72,84158,6211,181,250700,11,790,0.458333,0.001727,201
55079090400,Milwaukee,3356,526,872,3159,21,110,38,18,1522,1834,944,1014,1647,1606,41,1297,309,1674,833,841,129,480,61,52602,3356,76,132200,21,9,0.002396,0.006257,202
55079011200,Milwaukee,1937,155,182,1435,358,59,45,40,1110,827,967,633,1240,1228,12,938,290,1240,785,455,53,281,28,24750,1933,407,109700,358,42,0.011596,0.184822,203
55079010800,Milwaukee,2101,112,210,1786,142,60,45,62,1171,930,1040,739,1457,1405,52,1019,386,1481,902,579,85,348,94,23361,2091,301,113800,142,3,0.000781,0.067587,204
55079091100,Milwaukee,4490,1136,459,4282,65,14,73,46,2130,2360,1400,1495,2546,2433,113,2068,365,2579,1312,1267,94,987,100,74194,4481,52,167700,65,2268,0.870139,0.014477,205
55079090500,Milwaukee,332,81,35,133,189,0,10,0,238,94,158,58,0,0,0,0,0,0,0,0,0,0,0,0,5,5,0,189,20,0.004932,0.569277,206
55079009600,Milwaukee,2962,1413,81,169,2268,248,180,72,1422,1540,662,806,633,622,11,446,176,667,325,342,147,49,0,20980,2923,1317,36300,2268,50,0.013074,0.765699,207
55079009400,Milwaukee,2619,482,266,2273,52,10,180,82,1202,1417,822,1049,1540,1515,25,1311,204,1569,735,834,86,433,36,43005,2613,66,94800,52,64,0.018743,0.019855,208
55079009500,Milwaukee,2107,508,166,1561,419,15,43,45,930,1177,626,807,1184,1128,56,935,193,1184,527,657,77,357,66,47219,2096,133,98200,419,38,0.009434,0.198861,209
55079011700,Milwaukee,481,179,76,2,478,0,0,0,170,311,63,163,95,95,0,26,69,95,18,77,7,8,0,16750,467,190,33300,478,41,0.011006,0.993763,210
55079011600,Milwaukee,1085,220,262,53,973,0,29,30,537,548,305,298,176,176,0,96,80,176,85,91,24,4,0,8892,1078,528,28200,973,105,0.035337,0.896774,211
55079011500,Milwaukee,421,81,49,172,225,0,12,12,172,249,103,188,95,95,0,69,26,101,33,68,12,22,0,16932,409,199,74200,225,0,0.000000,0.534442,212
55079009700,Milwaukee,2053,894,134,104,1261,534,74,27,949,1104,429,596,383,383,0,188,195,383,158,225,102,13,0,17372,2024,1117,23500,1261,98,0.033906,0.614223,213
55079011400,Milwaukee,539,101,7,348,128,0,63,0,274,265,219,212,366,360,6,325,35,366,184,182,41,123,30,45268,539,114,133800,128,86,0.027132,0.237477,214
55079012000,Milwaukee,846,398,37,39,648,91,68,0,348,498,163,248,184,177,7,73,104,184,99,85,38,11,0,20789,793,369,41800,648,14,0.003661,0.765957,215
55079011900,Milwaukee,982,428,45,7,720,0,132,112,488,494,197,312,221,221,0,144,77,214,75,139,15,37,0,22012,973,299,52500,720,0,0.000000,0.733198,216
55079011800,Milwaukee,478,128,70,44,345,64,25,0,191,287,100,180,180,180,0,112,68,180,60,120,48,16,0,18304,478,82,46800,345,2201,0.861526,0.721757,217
55133203702,Milwaukee,5077,1204,300,4590,228,94,74,62,2670,2407,1916,1657,2791,2631,160,1868,763,2824,1500,1324,156,866,64,96958,4704,210,262300,228,63,0.018656,0.044908,218
55079011300,Milwaukee,1520,15,391,1228,149,11,72,45,948,572,767,347,775,733,42,591,142,780,547,233,7,282,49,16821,1153,211,189400,149,191,0.081337,0.098026,219
55133201203,Milwaukee,3179,681,766,3037,0,88,27,19,1414,1765,821,911,1489,1420,69,1144,276,1513,769,744,43,495,73,74112,2923,65,177600,0,1298,0.608172,0.000000,220
55079011000,Milwaukee,3093,90,383,2343,399,60,185,63,1581,1512,1367,1253,1985,1952,33,1504,448,2043,1078,965,90,533,70,20897,2966,552,147100,399,6,0.001814,0.129001,221
55079011100,Milwaukee,1645,90,165,1374,124,30,59,33,810,835,708,682,1132,1093,39,806,287,1137,551,586,35,419,36,32639,1633,282,155600,124,1724,0.757605,0.075380,222
55079091200,Milwaukee,4382,841,593,3985,86,161,84,66,2062,2320,1434,1514,2350,2292,58,1970,322,2352,1183,1169,145,676,72,45060,4380,319,125400,86,766,0.421387,0.019626,223
55079014100,Milwaukee,1318,650,52,3,1298,0,17,0,471,847,134,482,360,357,3,234,123,381,85,296,8,23,4,11202,1308,815,450000,1298,18,0.004828,0.984825,224
55079012100,Milwaukee,932,322,57,106,638,124,53,0,456,476,279,274,242,242,0,121,121,250,125,125,51,38,6,14350,926,436,34800,638,36,0.008684,0.684549,225
55079012200,Milwaukee,2981,1230,101,396,1538,726,203,107,1333,1648,684,966,782,782,0,435,347,789,325,464,162,114,6,19467,2953,1445,34900,1538,1245,0.575019,0.515934,226
55079013800,Milwaukee,1450,547,133,17,1266,94,42,13,619,831,284,486,262,262,0,152,110,275,113,162,23,7,0,13250,1407,738,43000,1266,83,0.025997,0.873103,227
55079013900,Milwaukee,992,298,77,47,872,41,0,32,532,460,301,316,301,301,0,153,148,307,146,161,50,46,0,24716,992,212,44800,872,1580,0.722205,0.879032,228
55079014000,Milwaukee,822,334,19,6,695,43,59,10,453,369,278,191,202,202,0,178,24,202,120,82,36,16,0,18194,780,437,51500,695,18,0.004727,0.845499,229
55133203101,Milwaukee,5789,1357,327,5390,16,181,177,7,2816,2973,2028,2077,3530,3405,125,2495,910,3569,1853,1716,278,1061,143,65117,5789,68,177400,16,44,0.011776,0.002764,230
55079012400,Milwaukee,2698,615,197,1599,582,323,113,81,1268,1430,864,1022,1455,1443,12,1109,334,1476,700,776,154,309,37,34704,2657,369,70800,582,68,0.020942,0.215715,231
55133203000,Milwaukee,2685,366,338,2279,147,7,200,33,1600,1085,1280,701,1072,1054,18,833,221,1104,563,541,175,177,19,40656,1949,93,117900,147,5,0.000987,0.054749,232
55079012300,Milwaukee,1265,436,74,177,898,36,113,41,612,653,333,422,410,410,0,264,146,417,191,226,63,61,10,17383,1265,617,39400,898,76,0.022979,0.709881,233
55133202900,Milwaukee,8055,1541,1332,7236,48,441,247,58,3968,4087,2651,2531,4264,4142,122,3368,774,4349,2425,1924,342,1377,368,49147,8041,325,155200,48,193,0.081784,0.005959,234
55079013600,Milwaukee,2621,511,506,806,1542,78,50,36,1215,1406,760,844,737,702,35,551,151,742,390,352,96,112,0,17137,2199,831,81400,1542,973,0.529926,0.588325,235
55079013700,Milwaukee,1916,577,76,127,1382,193,155,38,904,1012,634,629,570,552,18,354,198,583,298,285,67,104,13,14224,1916,819,66700,1382,13,0.003330,0.721294,236
55079014800,Milwaukee,1909,321,120,807,766,267,59,10,1033,876,800,668,832,763,69,535,228,842,391,451,67,154,53,18370,1464,443,60600,766,2291,0.879032,0.401257,237
55079014600,Milwaukee,3804,158,175,2758,676,159,91,87,1865,1939,1681,1790,1984,1950,34,1766,184,2067,956,1111,76,283,15,9992,2216,1214,52100,676,72,0.021663,0.177708,238
55079014700,Milwaukee,2484,309,76,1437,703,80,198,54,1099,1385,943,1156,1042,1019,23,943,76,1123,431,692,49,263,51,11090,1978,1235,40600,703,0,0.000000,0.283011,239
55079014500,Milwaukee,2013,0,33,808,1124,21,0,0,1662,351,1629,351,4,4,0,4,0,4,0,4,0,1,0,0,120,117,0,1124,1336,0.621600,0.558371,240
55079090600,Milwaukee,4752,758,1370,4480,114,53,24,14,2231,2521,1300,1324,2266,2214,52,1806,408,2266,1163,1103,178,632,131,51472,4564,204,122800,114,12,0.003097,0.023990,241
55079014300,Milwaukee,2148,0,256,1779,186,76,55,14,1207,941,1092,800,1629,1592,37,1292,300,1644,937,707,81,649,90,31938,2148,296,162500,186,15,0.003765,0.086592,242
55079014400,Milwaukee,2453,65,136,1897,163,219,93,69,1544,909,1445,807,1683,1626,57,1439,187,1710,1018,692,17,836,256,43542,2003,199,238500,163,18,0.004626,0.066449,243
55079091400,Milwaukee,2219,470,201,2099,55,0,16,27,1066,1153,750,798,1283,1233,50,1061,172,1294,628,666,83,379,57,47882,2215,64,128800,55,0,0.000000,0.024786,244
55079091300,Milwaukee,3685,801,691,3453,32,84,56,53,1718,1967,1081,1112,1926,1816,110,1507,309,1953,1036,917,43,712,69,67475,3666,54,180700,32,6,0.001687,0.008684,245
55079012500,Milwaukee,2038,421,264,1805,24,113,85,11,973,1065,640,713,1120,1103,17,904,199,1131,582,549,84,293,58,47125,2038,159,132100,24,36,0.008598,0.011776,246
55079015200,Milwaukee,444,6,16,356,63,8,0,17,208,236,202,220,344,324,20,302,22,349,183,166,19,123,0,46548,444,71,210000,63,838,0.503131,0.141892,247
55079013500,Milwaukee,2252,509,44,308,1561,45,288,37,1296,956,985,714,896,888,8,572,316,911,525,386,96,110,7,17949,2252,750,97100,1561,58,0.017451,0.693162,248
55079015100,Milwaukee,1345,28,14,1081,110,64,47,26,485,860,451,852,706,699,7,639,60,733,261,472,17,91,0,19922,305,141,0,110,0,0.000000,0.081784,249
55133203102,Milwaukee,6398,1431,929,5876,30,40,286,151,3141,3257,2073,1965,3325,3293,32,2362,931,3411,1833,1578,370,749,81,56210,6255,245,139400,30,2123,0.860048,0.004689,250
55079015300,Milwaukee,491,6,0,442,18,7,0,19,329,162,329,156,348,328,20,246,82,363,222,141,29,150,35,53125,463,97,156900,18,1542,0.720479,0.036660,251
55079013300,Milwaukee,1206,354,77,539,195,256,102,18,668,538,420,355,474,463,11,348,115,474,259,215,64,67,12,30357,1196,226,44900,195,0,0.000000,0.161692,252
55079012800,Milwaukee,2844,492,338,2474,127,167,70,6,1330,1514,956,1058,1459,1456,3,1265,191,1464,680,784,73,338,41,41631,2460,295,102700,127,39,0.009786,0.044655,253
55079013400,Milwaukee,2771,939,150,507,1503,239,293,198,1335,1436,770,912,927,886,41,638,248,953,405,548,164,120,15,17401,2771,941,54600,1503,15,0.003788,0.542403,254
55079014900,Milwaukee,1689,294,86,577,675,105,293,39,931,758,740,569,843,843,0,456,387,878,561,317,144,78,26,19451,1689,611,29600,675,676,0.331551,0.399645,255
55079015000,Milwaukee,666,4,99,452,126,41,26,14,387,279,306,257,296,290,6,282,8,296,173,123,12,61,5,10389,601,261,0,126,703,0.395997,0.189189,256
55079012600,Milwaukee,2233,387,286,2059,51,0,93,30,1061,1172,763,797,1391,1379,12,1180,199,1416,700,716,190,255,47,39858,2187,45,85100,51,275,0.095671,0.022839,257
55133201102,Milwaukee,3068,637,598,2861,15,115,50,27,1533,1535,938,895,1536,1493,43,1266,227,1563,874,689,126,394,42,66083,3062,92,157800,15,1096,0.558371,0.004889,258
55079012700,Milwaukee,1177,160,196,1144,0,16,10,4,551,626,391,430,728,717,11,548,169,748,367,381,81,163,17,43167,1163,49,94300,0,2670,0.940472,0.000000,259
55079013200,Milwaukee,955,214,197,417,106,82,327,0,515,440,289,255,338,309,29,212,97,355,192,163,92,43,0,16346,948,341,71400,106,279,0.098026,0.110995,260
55079013100,Milwaukee,430,0,140,286,134,0,6,4,381,49,247,43,24,24,0,24,0,32,21,11,8,11,6,0,38,6,0,134,1503,0.691403,0.311628,261
55133203103,Milwaukee,4663,992,659,4168,72,56,359,8,2328,2335,1489,1523,2519,2502,17,1976,526,2547,1362,1185,365,557,113,48031,4641,167,118300,72,1153,0.568035,0.015441,262
55079013000,Milwaukee,1788,442,143,1545,105,0,83,49,857,931,576,627,962,951,11,784,167,968,476,492,108,154,18,32237,1778,191,81100,105,68,0.019907,0.058725,263
55079012900,Milwaukee,2906,500,363,2479,9,0,244,154,1455,1451,1059,984,1586,1574,12,1366,208,1614,886,728,218,204,31,41621,2886,188,81200,9,55,0.016757,0.003097,264
55133202800,Milwaukee,3547,860,376,2404,7,27,1018,68,1816,1731,1190,1121,1845,1820,25,1504,316,1913,1003,910,385,223,56,42926,3447,260,98500,7,64,0.018707,0.001973,265
55079100800,Milwaukee,3102,580,542,2920,18,29,108,0,1549,1553,1007,973,1634,1613,21,1392,221,1640,860,780,184,256,47,49167,3094,105,106900,18,4040,0.987286,0.005803,266
55079100700,Milwaukee,3114,744,450,2915,16,52,73,29,1586,1528,960,960,1587,1553,34,1354,199,1599,789,810,207,296,26,50273,3114,79,97600,16,0,0.000000,0.005138,267
55133204001,Milwaukee,7652,1811,820,7398,29,23,74,96,3841,3811,2559,2462,4159,3986,173,2149,1837,4211,2241,1970,350,1073,82,69157,7462,157,196300,29,39,0.009521,0.003790,268
55079015400,Milwaukee,278,24,8,194,10,0,56,0,193,85,169,77,171,164,7,112,52,154,105,49,37,20,0,19938,261,51,57900,10,26,0.005862,0.035971,269
55079015600,Milwaukee,1063,328,50,144,59,27,833,0,644,419,414,271,406,406,0,213,193,411,316,95,151,5,0,24423,1063,297,52500,59,872,0.510270,0.055503,270
55079015500,Milwaukee,911,201,92,240,51,0,597,20,535,376,389,229,419,419,0,330,89,428,307,121,115,49,26,20662,911,228,53100,51,10,0.002701,0.055982,271
55079100600,Milwaukee,2096,313,382,2037,0,0,17,29,1007,1089,759,642,1140,1126,14,1023,103,1152,596,556,160,245,37,41442,2096,67,94600,0,0,0.000000,0.000000,272
55079100200,Milwaukee,3446,661,481,3040,73,54,203,50,1674,1772,1186,1118,1772,1765,7,1330,435,1808,971,837,251,314,61,31594,3422,398,77600,73,358,0.184822,0.021184,273
55079100100,Milwaukee,3667,836,352,3223,73,62,248,36,1809,1858,1231,1248,1879,1841,38,1491,350,1897,947,950,272,311,29,36500,3656,297,88300,73,1561,0.721757,0.019907,274
55079110100,Milwaukee,4249,763,614,3264,50,173,535,69,2106,2143,1563,1309,2143,2119,24,1658,461,2160,1172,988,353,345,42,35098,4241,482,91600,50,10,0.002655,0.011767,275
55079100300,Milwaukee,3077,679,504,2862,0,13,177,10,1472,1605,928,966,1443,1438,5,1097,341,1488,730,758,192,163,3,31437,3053,274,91600,0,51,0.013226,0.000000,276
55079015900,Milwaukee,3645,1038,366,1043,320,264,1898,80,1809,1836,1144,1097,1192,1187,5,733,454,1251,711,540,265,52,11,24271,3601,818,62700,320,3491,0.984825,0.087791,277
55079015800,Milwaukee,3381,1063,141,732,275,29,2158,96,1930,1451,1271,906,1241,1225,16,616,609,1276,863,413,320,70,11,22829,3376,1317,48100,275,84,0.026128,0.081337,278
55079015700,Milwaukee,3742,1152,163,568,358,0,2797,0,2154,1588,1419,1008,1414,1382,32,927,455,1421,948,473,372,52,0,25873,3717,1224,38200,358,27,0.006022,0.095671,279
55079100400,Milwaukee,2647,548,268,2464,50,0,50,37,1320,1327,967,864,1467,1451,16,1186,265,1486,751,735,180,305,41,40000,2636,211,95300,50,12,0.002863,0.018889,280
55079016000,Milwaukee,3029,923,259,1093,115,191,1326,104,1583,1446,958,889,1081,1071,10,783,288,1095,574,521,269,89,0,30888,3029,521,54400,115,21,0.005148,0.037966,281
55133203804,Milwaukee,5892,1573,322,5688,3,36,75,29,3006,2886,2030,1967,3359,3211,148,2153,1058,3399,1865,1534,283,903,94,76046,5888,26,189200,3,17,0.004203,0.000509,282
55079000000,Milwaukee,0,0,0,0,0,0,0,0,0,0,0,0,0,0,0,0,0,0,0,0,0,0,0,0,0,0,0,0,115,0.039752,0.000000,283
55079016100,Milwaukee,3232,972,247,1362,73,172,1407,36,1619,1613,1044,969,1153,1149,4,862,287,1173,689,484,286,98,0,33164,3194,720,59400,73,0,0.000000,0.022587,284
55079016200,Milwaukee,3311,1027,361,1111,117,179,1630,103,1699,1612,1051,872,947,947,0,606,341,986,566,420,215,68,0,32208,3294,687,58200,117,6,0.001743,0.035337,285
55079016300,Milwaukee,5197,1717,341,1134,388,168,3323,116,2747,2450,1646,1493,1616,1588,28,976,612,1687,918,769,455,97,21,26475,5047,1518,43200,388,68,0.020408,0.074658,286
55079016400,Milwaukee,5180,1679,207,706,483,212,3613,6,2894,2286,1952,1342,1769,1735,34,967,768,1878,1322,556,429,114,6,25000,5120,1957,40400,483,77,0.023990,0.093243,287
55079016500,Milwaukee,2770,924,207,385,254,45,2073,13,1506,1264,863,776,862,858,4,542,316,894,570,324,311,72,0,23654,2748,881,34400,254,203,0.086592,0.091697,288
55133201300,Milwaukee,4650,1037,508,4328,37,144,71,64,2258,2392,1519,1586,2603,2560,43,1958,602,2632,1368,1264,195,716,165,65223,4637,103,157900,37,16,0.003790,0.007957,289
55133201401,Milwaukee,8376,1608,1212,7911,80,202,149,34,4044,4332,2716,2840,4666,4567,99,3638,929,4699,2554,2145,344,1483,196,57453,8368,318,155300,80,46,0.012320,0.009551,290
55133202700,Milwaukee,1845,179,374,1328,69,34,384,15,862,983,669,623,929,921,8,748,173,935,485,450,103,158,29,25591,1778,368,58200,69,832,0.493452,0.037398,291
55133201402,Milwaukee,4723,827,1009,4411,75,147,24,38,2200,2523,1395,1492,2336,2270,66,1866,404,2381,1220,1161,213,624,121,54926,4583,127,145000,75,1786,0.758819,0.015880,292
55079100500,Milwaukee,3570,689,547,3278,71,39,29,112,1706,1864,1207,1127,1778,1744,34,1487,257,1834,952,882,227,308,69,39722,3436,168,94500,71,0,0.000000,0.019888,293
55079100900,Milwaukee,3718,581,693,3330,14,185,126,51,1673,2045,1171,1273,2126,2117,9,1726,391,2166,1048,1118,189,465,101,33186,3686,306,74100,14,829,0.478686,0.003765,294
55133202500,Milwaukee,4011,923,521,3599,26,14,307,49,1909,2102,1274,1293,2113,2102,11,1731,371,2172,1118,1054,238,462,59,48926,3994,174,123900,26,39,0.009481,0.006482,295
55079016600,Milwaukee,2221,580,74,480,179,16,1524,22,1217,1004,918,649,756,756,0,574,182,756,489,267,219,55,0,22377,2206,853,28300,179,284,0.111389,0.080594,296
55133202202,Milwaukee,6116,1164,1085,5338,113,63,468,75,2959,3157,2036,1831,3213,3146,67,2312,834,3218,1758,1460,336,651,115,44143,5885,606,129600,113,178,0.059097,0.018476,297
55079016700,Milwaukee,3568,1216,171,538,193,109,2555,97,1918,1650,1167,1014,1124,1124,0,683,441,1202,762,440,393,59,0,23605,3563,1168,45600,193,54,0.015880,0.054092,298
55079017000,Milwaukee,5317,1544,596,2313,281,226,2237,69,2661,2656,1589,1588,1942,1942,0,1209,733,2023,1032,991,447,138,12,29850,5199,1202,61800,281,37,0.009186,0.052849,299
55079016800,Milwaukee,3232,1073,174,653,191,20,2210,75,1669,1563,1046,939,1056,1046,10,695,351,1100,644,456,240,25,0,23018,3224,1161,42600,191,2246,0.867133,0.059097,300
55079017100,Milwaukee,2537,720,226,1314,58,70,977,60,1283,1254,832,759,1061,1061,0,822,239,1093,622,471,180,125,16,35250,2480,307,71400,58,888,0.511194,0.022862,301
55133202201,Milwaukee,4538,1191,277,4374,0,51,101,12,2277,2261,1527,1543,2638,2559,79,1818,741,2660,1433,1227,101,872,50,80501,4519,57,176400,0,73,0.021861,0.000000,302
55079016900,Milwaukee,3946,1251,368,1298,227,100,2059,138,1962,1984,1194,1133,1094,1088,6,644,444,1147,648,499,349,100,0,22022,3860,1273,41500,227,163,0.056562,0.057527,303
55133202600,Milwaukee,3158,462,370,2628,7,36,422,22,1564,1594,1198,1128,1738,1699,39,1316,383,1783,945,838,221,199,26,32985,2690,362,111600,7,52,0.013442,0.002217,304
55079101500,Milwaukee,4608,1001,514,4262,0,76,180,79,2238,2370,1554,1539,2463,2393,70,1962,431,2507,1296,1211,309,331,22,39267,4581,368,93800,0,1544,0.721294,0.000000,305
55079101400,Milwaukee,3824,661,677,3548,42,88,79,57,1913,1911,1337,1149,2083,2048,35,1752,296,2108,1149,959,346,308,41,41659,3705,200,96500,42,141,0.052849,0.010983,306
55079101600,Milwaukee,4526,851,850,4226,6,18,229,35,2164,2362,1445,1380,2397,2362,35,1855,507,2444,1287,1157,327,346,54,39028,4357,201,99600,6,108,0.036660,0.001326,307
55079017200,Milwaukee,2107,543,172,1088,0,131,842,45,1044,1063,737,655,936,936,0,713,223,980,538,442,306,63,6,32484,2102,342,70100,0,114,0.039290,0.000000,308
55079017300,Milwaukee,3422,1143,266,1495,92,145,1415,166,1673,1749,1036,977,1372,1367,5,987,380,1440,782,658,283,216,32,33305,3408,810,64300,92,21,0.005138,0.026885,309
55079017400,Milwaukee,2742,931,168,910,109,205,1378,87,1407,1335,866,777,841,830,11,577,253,868,553,315,226,50,0,26172,2742,918,47600,109,7,0.001973,0.039752,310
55079017500,Milwaukee,4159,1322,221,1204,175,71,2406,141,2096,2063,1405,1211,918,911,7,647,264,1049,546,503,262,77,0,24931,4128,1340,47000,175,24,0.005686,0.042077,311
55079017600,Milwaukee,3147,1121,201,861,178,75,1896,111,1622,1525,932,893,875,845,30,654,191,932,558,374,255,79,0,25814,3141,1208,52900,178,37,0.009186,0.056562,312
55079017800,Milwaukee,241,59,15,75,36,0,126,4,131,110,105,62,67,67,0,62,5,67,40,27,6,6,0,16848,234,83,45900,36,1266,0.608011,0.149378,313
55079017700,Milwaukee,1645,443,180,768,66,0,732,32,812,833,529,493,455,455,0,264,191,486,266,220,54,30,0,22258,1633,451,46500,66,0,0.000000,0.040122,314
55079018002,Milwaukee,1673,361,166,1318,21,0,304,14,844,829,611,535,867,867,0,659,208,888,485,403,132,126,41,32281,1660,290,70000,21,0,0.000000,0.012552,315
55133202301,Milwaukee,3540,848,303,3307,0,59,143,25,1743,1797,1165,1224,1946,1918,28,1417,501,1959,992,967,257,358,65,59958,3520,155,145300,0,0,0.000000,0.000000,316
55079101700,Milwaukee,3487,663,451,3297,21,20,39,98,1679,1808,1189,1184,1864,1828,36,1327,501,1912,1006,906,205,360,27,43687,3478,128,96900,21,30,0.007452,0.006022,317
55079017900,Milwaukee,3214,731,323,2408,69,115,498,91,1632,1582,1090,1070,1323,1300,23,999,301,1402,743,659,222,207,4,26439,3160,832,74600,69,6,0.001727,0.021469,318
55079019000,Milwaukee,4350,807,705,3858,21,73,376,22,2096,2254,1394,1444,2346,2320,26,1844,476,2376,1180,1196,272,425,51,41960,4342,95,100800,21,151,0.055982,0.004828,319
55133202400,Milwaukee,5281,1032,574,4842,12,101,265,53,2488,2793,1724,1951,3078,3003,75,2368,635,3178,1562,1616,233,835,120,62063,4809,107,150100,12,3076,0.959747,0.002272,320
55133202302,Milwaukee,6982,1758,488,5634,117,114,1003,60,3354,3628,2245,2491,3817,3732,85,2717,1015,3878,1918,1960,533,724,146,44241,6933,387,116200,117,175,0.058970,0.016757,321
55079101000,Milwaukee,5338,1053,943,4428,284,241,259,80,2483,2855,1635,1707,2536,2497,39,2061,436,2572,1353,1219,207,600,111,41365,5330,617,156500,284,1812,0.760495,0.053203,322
55079018800,Milwaukee,1904,623,166,735,95,89,887,16,928,976,545,570,611,611,0,367,244,623,366,257,170,25,7,27073,1895,478,61600,95,1366,0.627627,0.049895,323
55079101300,Milwaukee,3265,607,643,3046,39,9,124,41,1566,1699,991,1024,1559,1548,11,1300,248,1587,799,788,192,254,34,40477,3241,150,109900,39,0,0.000000,0.011945,324
55079101100,Milwaukee,1908,311,314,1797,18,46,41,0,1035,873,679,604,1005,990,15,782,208,1040,593,447,130,258,17,35273,1908,118,116600,18,2509,0.934216,0.009434,325
55079018001,Milwaukee,1148,225,140,974,58,0,46,7,525,623,346,437,603,583,20,420,163,608,280,328,68,90,18,28220,1141,203,81200,58,65,0.018921,0.050523,326
55079018100,Milwaukee,1684,252,230,1522,44,8,96,14,781,903,542,660,1068,1044,24,831,213,1102,502,600,86,263,11,44405,1684,173,127300,44,2506,0.933806,0.026128,327
55079018900,Milwaukee,1466,353,166,984,17,42,396,16,666,800,471,476,660,640,20,537,103,676,318,358,75,130,7,37896,1454,227,65800,17,1426,0.684549,0.011596,328
55079101800,Milwaukee,2635,288,864,2555,29,8,25,18,1179,1456,689,794,1188,1173,15,991,182,1216,614,602,123,236,37,41389,2604,141,126100,29,25,0.005803,0.011006,329
55079018700,Milwaukee,3509,1037,287,1593,85,65,1623,85,1764,1745,1078,1107,1149,1139,10,939,200,1187,666,521,259,85,0,28419,3448,685,66300,85,0,0.000000,0.024223,330
55079018600,Milwaukee,2688,880,145,1344,65,21,1088,118,1437,1251,902,761,1115,1102,13,706,396,1140,622,518,331,47,0,36025,2662,543,60100,65,86,0.026885,0.024182,331
55079019200,Milwaukee,3104,448,742,2840,39,29,185,0,1470,1634,938,976,1566,1549,17,1120,429,1586,836,750,176,246,30,43005,3104,99,97900,39,66,0.019626,0.012564,332
55079019300,Milwaukee,2616,445,596,2468,0,0,109,11,1275,1341,812,763,1245,1239,6,883,356,1300,682,618,181,227,25,44663,2595,51,99500,0,55,0.016009,0.000000,333
55079018500,Milwaukee,1606,320,234,1320,6,28,200,25,774,832,514,538,849,830,19,602,228,873,419,454,117,128,31,42333,1600,39,98300,6,146,0.054092,0.003736,334
55079018200,Milwaukee,1739,249,205,1607,23,6,97,6,927,812,674,611,1092,1044,48,906,138,1097,598,499,86,279,65,53787,1739,82,130600,23,63,0.018476,0.013226,335
55079020100,Milwaukee,3212,662,758,2279,151,70,663,21,1378,1834,801,991,1358,1341,17,981,360,1394,690,704,178,136,16,32690,3170,343,89100,151,19,0.004895,0.047011,336
55079101200,Milwaukee,3276,521,1110,3120,0,56,51,6,1450,1826,832,813,1380,1329,51,1078,251,1408,736,672,126,221,20,41632,3120,116,106100,0,73,0.022088,0.000000,337
55079018300,Milwaukee,2585,527,262,2278,56,13,210,21,1317,1268,902,894,1362,1342,20,1088,254,1382,752,630,182,319,31,41089,2579,251,91000,56,0,0.000000,0.021663,338
55079018400,Milwaukee,1468,282,192,1360,0,5,96,0,780,688,540,454,825,810,15,595,215,837,429,408,134,145,7,36505,1468,161,84400,0,69,0.021184,0.000000,339
55079020000,Milwaukee,3283,504,649,2409,168,155,450,47,1478,1805,978,1152,1477,1454,23,1086,368,1485,770,715,233,322,39,30356,3258,487,99200,168,17,0.004346,0.051173,340
55079020400,Milwaukee,2568,575,344,1837,15,25,549,63,1269,1299,816,833,1223,1183,40,934,249,1241,596,645,204,169,18,37578,2547,250,88100,15,69,0.021292,0.005841,341
55079020500,Milwaukee,2597,662,238,1696,0,81,747,12,1271,1326,864,833,1333,1300,33,1025,275,1344,718,626,221,181,5,38661,2597,199,81200,0,5199,0.000000,0.000000,342
55133203803,Milwaukee,3552,931,243,3429,0,15,53,17,1775,1777,1229,1149,1919,1872,47,1179,693,1930,1068,862,258,390,28,67682,3548,65,167300,0,113,0.037966,0.000000,343
55133202100,Milwaukee,9117,2500,508,8577,38,87,227,188,4563,4554,3066,3043,4911,4726,185,3158,1568,4992,2720,2272,427,1419,118,70387,9105,96,192000,38,1308,0.614223,0.004168,344
55079019100,Milwaukee,3080,460,602,2604,76,62,273,20,1375,1705,912,1106,1559,1535,24,1205,330,1582,745,837,116,245,31,37588,2834,209,115700,76,189,0.074658,0.024675,345
55079019800,Milwaukee,4815,847,1083,4443,50,12,219,0,2253,2562,1389,1496,2441,2406,35,1853,553,2441,1213,1228,304,418,58,41610,4768,230,94100,50,16,0.003907,0.010384,346
55079019600,Milwaukee,3505,483,1066,3253,27,55,135,23,1588,1917,956,1000,1569,1541,28,1191,350,1612,847,765,242,230,31,32231,3498,241,113900,27,106,0.035971,0.007703,347
55079120100,Milwaukee,7855,1422,1496,7357,57,181,178,77,3631,4224,2393,2544,4124,4065,59,3271,794,4177,2195,1982,401,1149,121,56382,7810,334,159100,57,281,0.110995,0.007257,348
55133201503,Milwaukee,6587,1652,645,6187,5,303,44,15,3233,3354,2122,2168,3411,3352,59,2649,703,3459,1884,1575,150,1344,118,88805,6542,43,201400,5,6,0.001326,0.000759,349
55079019400,Milwaukee,3645,568,769,3295,68,59,166,37,1652,1993,1076,1232,1914,1897,17,1501,396,1921,907,1014,276,325,45,41595,3645,193,115400,68,38,0.009259,0.018656,350
55133101000,Milwaukee,4,0,0,2,0,0,0,2,3,1,3,1,4,4,0,4,0,4,3,1,0,2,0,152338,4,0,137500,0,23,0.005672,0.000000,351
55079020700,Milwaukee,4505,838,728,4213,15,22,225,15,2165,2340,1442,1497,2515,2486,29,1971,515,2584,1259,1325,394,308,21,42846,4505,296,89500,15,2,0.000509,0.003330,352
55079020600,Milwaukee,3530,645,589,3053,61,38,281,36,1696,1834,1115,1181,1818,1806,12,1455,351,1857,924,933,170,381,70,39871,3502,206,93000,61,0,0.000000,0.017280,353
55079120300,Milwaukee,1992,440,378,1742,44,0,191,11,904,1088,542,632,974,974,0,801,173,992,492,500,127,183,22,44375,1992,113,107700,44,1705,0.741513,0.022088,354
55079020800,Milwaukee,3308,567,475,3000,6,4,200,44,1611,1697,1127,1139,1889,1833,56,1473,360,1922,961,961,70,423,17,44879,3282,223,105000,6,742,0.399959,0.001814,355
55133201600,Milwaukee,4823,1072,512,4673,0,25,68,40,2420,2403,1651,1588,2744,2574,170,1953,621,2756,1460,1296,181,659,82,69425,4800,46,158600,0,98,0.033515,0.000000,356
55079185100,Milwaukee,3541,441,767,3258,67,23,150,21,1717,1824,1208,1125,1871,1802,69,1488,314,1942,1057,885,203,415,54,34666,3541,297,96300,67,85,0.026555,0.018921,357
55133201506,Milwaukee,4274,766,404,4055,12,87,80,20,2049,2225,1525,1579,2596,2497,99,1948,549,2647,1333,1314,282,702,89,70769,4233,45,156700,12,478,0.200896,0.002808,358
55079020300,Milwaukee,3136,602,616,2696,41,9,361,29,1495,1641,936,982,1624,1602,22,1326,276,1624,854,770,235,273,38,41027,3136,132,94200,41,2044,0.845499,0.013074,359
55079019900,Milwaukee,3477,653,674,3179,0,0,224,41,1749,1728,1128,1022,1807,1784,23,1421,363,1828,1015,813,224,255,27,45684,3452,165,103100,0,7,0.001816,0.000000,360
55079019500,Milwaukee,3374,744,473,3088,29,45,142,48,1651,1723,1086,1071,1794,1741,53,1303,438,1808,948,860,148,315,70,52574,3359,79,124000,29,2656,0.936928,0.008595,361
55079019700,Milwaukee,5323,1047,1027,4654,115,154,248,131,2448,2875,1524,1725,2640,2640,0,1980,660,2702,1331,1371,223,363,17,44788,5323,425,122900,115,2308,0.880430,0.021604,362
55079020200,Milwaukee,2681,510,647,2242,140,40,191,46,1256,1425,736,788,1226,1205,21,914,291,1244,597,647,180,157,19,36420,2675,220,88400,140,36,0.008624,0.052219,363
55133201505,Milwaukee,3265,921,353,3165,0,13,20,22,1667,1598,1018,973,1624,1590,34,1165,425,1624,920,704,103,410,32,76499,3252,99,165100,0,21,0.005067,0.000000,364
55079120400,Milwaukee,6837,1038,1384,6191,47,162,259,100,3230,3607,2176,2239,3522,3429,93,2714,715,3615,1784,1831,357,651,109,42780,6376,268,109400,47,2771,0.942873,0.006874,365
55079185200,Milwaukee,5122,973,777,4666,82,71,248,23,2536,2586,1698,1674,2646,2625,21,2169,456,2729,1455,1274,365,384,39,39089,5074,259,95000,82,0,0.000000,0.016009,366
55079120202,Milwaukee,3136,450,701,2894,25,37,154,6,1470,1666,982,1003,1618,1609,9,1307,302,1621,869,752,277,239,18,36949,3136,213,102000,25,1862,0.783060,0.007972,367
55079120201,Milwaukee,3473,566,574,3280,17,89,59,19,1614,1859,1059,1274,2057,2044,13,1592,452,2096,919,1177,129,456,51,45822,3473,110,112400,17,2879,0.944864,0.004895,368
55079021300,Milwaukee,1283,309,255,983,43,0,177,53,584,699,313,406,584,574,10,419,155,589,264,325,92,79,17,40250,1267,132,104000,43,2931,0.951745,0.033515,369
55079021200,Milwaukee,2071,308,438,1833,9,57,115,21,1041,1030,679,646,1006,1001,5,850,151,1034,574,460,125,94,9,35523,2062,93,82800,9,50,0.012787,0.004346,370
55079021100,Milwaukee,1407,233,204,1320,8,0,59,20,737,670,528,442,769,746,23,547,199,804,441,363,100,129,9,46548,1407,41,91500,8,29,0.006309,0.005686,371
55079020900,Milwaukee,2697,549,463,2529,0,34,134,0,1313,1384,814,871,1402,1397,5,1021,376,1461,748,713,188,185,36,42866,2697,138,99300,0,41,0.010451,0.000000,372
55079021000,Milwaukee,2074,438,352,1726,5,0,192,115,1024,1050,652,632,1027,1014,13,697,317,1032,571,461,97,223,45,46000,2062,138,99500,5,57,0.017280,0.002411,373
55079021400,Milwaukee,3037,639,630,2312,98,183,399,37,1376,1661,831,937,1214,1210,4,900,310,1282,632,650,205,214,51,29259,3037,491,112800,98,695,0.386673,0.032269,374
55079180100,Milwaukee,3157,570,560,2939,29,45,86,50,1517,1640,1010,1017,1616,1581,35,1184,397,1663,885,778,279,351,41,45965,3150,194,109300,29,0,0.000000,0.009186,375
55079180300,Milwaukee,3612,1018,321,2969,98,36,325,141,1820,1792,1153,1120,1751,1708,43,1268,440,1814,996,818,319,144,20,37381,3569,503,95100,98,0,0.000000,0.027132,376
55079120203,Milwaukee,3442,498,609,3135,6,37,196,64,1603,1839,1159,1176,1865,1797,68,1416,381,1962,1026,936,200,287,40,43619,3429,220,118300,6,0,0.000000,0.001743,377
55079180200,Milwaukee,4607,926,645,4222,18,20,192,102,2250,2357,1543,1493,2285,2250,35,1653,597,2303,1191,1112,441,213,37,34500,4550,416,93900,18,582,0.237477,0.003907,378
55079120502,Milwaukee,4654,582,1494,4312,22,187,102,3,2092,2562,1248,1330,2234,2161,73,1556,605,2269,1123,1146,232,481,34,37150,4468,120,126300,22,1841,0.765699,0.004727,379
55079021500,Milwaukee,2754,534,524,2339,5,173,201,36,1284,1470,812,884,1312,1299,13,1050,249,1360,695,665,146,228,13,52240,2639,51,118700,5,1542,0.714556,0.001816,380
55079021600,Milwaukee,4097,912,444,3490,0,32,360,99,2027,2070,1367,1374,2185,2173,12,1587,586,2222,1172,1050,259,379,30,46979,4090,108,109500,0,0,0.000000,0.000000,381
55133201504,Milwaukee,5009,1247,558,4897,12,0,5,76,2529,2480,1608,1596,2710,2630,80,1895,735,2747,1512,1235,211,857,170,75584,5001,0,167100,12,29,0.006482,0.002396,382
55079021700,Milwaukee,6028,1131,933,5195,63,112,505,96,3014,3014,2055,1909,3206,3183,23,2412,771,3296,1771,1525,296,454,119,50285,5882,347,108700,63,342,0.153341,0.010451,383
55079140100,Milwaukee,3157,479,804,2969,29,140,7,0,1438,1719,908,966,1498,1426,72,1177,249,1536,839,697,91,535,17,66583,3157,70,204500,29,58,0.017330,0.009186,384
55079130100,Milwaukee,4798,843,857,4552,13,0,198,19,2265,2533,1492,1606,2788,2699,89,2088,611,2788,1430,1358,219,640,129,52309,4792,92,146600,13,530,0.229218,0.002709,385
55079140201,Milwaukee,5324,982,1189,5090,11,87,69,40,2510,2814,1488,1665,2734,2647,87,1963,684,2771,1370,1401,267,578,62,48198,5241,185,129800,11,181,0.067587,0.002066,386
55079120501,Milwaukee,3978,815,531,3498,181,84,215,0,1933,2045,1274,1358,2178,2153,25,1551,602,2198,1077,1121,219,409,54,49672,3978,270,134100,181,15,0.003759,0.045500,387
55079140202,Milwaukee,5924,1226,894,5580,16,30,192,67,2930,2994,1849,1955,2928,2819,109,2099,720,2998,1495,1503,190,846,112,57250,5914,306,144800,16,227,0.088126,0.002701,388
55079021800,Milwaukee,2330,404,578,2066,0,24,158,32,1036,1294,605,743,1002,992,10,664,328,1034,498,536,217,149,26,38800,2174,158,113300,0,1134,0.565001,0.000000,389
55079130200,Milwaukee,2966,616,577,2837,0,54,64,5,1420,1546,856,917,1512,1468,44,1151,317,1532,799,733,147,426,69,57632,2966,62,147800,0,483,0.204489,0.000000,390
55079180400,Milwaukee,2748,433,746,2538,0,5,79,30,1269,1479,779,790,1270,1240,30,939,301,1283,696,587,242,186,18,38420,2738,158,103500,0,2885,0.945501,0.000000,391
55079180500,Milwaukee,4305,888,643,3972,10,56,162,35,2074,2231,1342,1432,2261,2236,25,1668,568,2321,1221,1100,329,461,71,45712,4292,234,118500,10,2001,0.825107,0.002323,392
55133204002,Milwaukee,4789,1294,320,4578,18,5,92,57,2375,2414,1616,1559,2568,2503,65,1184,1319,2595,1426,1169,290,587,58,64280,4762,149,167400,18,5,0.000914,0.003759,393
55079150100,Milwaukee,7226,1629,851,6522,97,226,263,57,3445,3781,2320,2426,3992,3865,127,2762,1103,4061,2104,1957,363,1018,138,60378,7191,321,151300,97,151,0.056139,0.013424,394
55133203802,Milwaukee,5201,1501,207,5030,17,53,50,51,2708,2493,1783,1710,2983,2931,52,1395,1536,3017,1652,1365,267,698,89,79445,5201,88,197500,17,358,0.177708,0.003269,395
55079160100,Milwaukee,6413,1213,668,5784,82,116,277,104,3235,3178,2315,2217,3483,3455,28,2445,1010,3596,1927,1669,388,714,154,50953,6395,205,125200,82,5,0.000975,0.012787,396
55079150302,Milwaukee,7326,1502,873,6950,0,184,86,100,3618,3708,2448,2503,4198,4082,116,2712,1370,4255,2171,2084,338,1216,147,61302,7310,156,141500,0,2209,0.863837,0.000000,397
55079150301,Milwaukee,5382,1082,557,5170,41,26,122,14,2724,2658,1907,1836,3087,2943,144,2191,752,3139,1610,1529,313,667,52,67719,5374,191,151000,41,14,0.003400,0.007618,398
55133202001,Milwaukee,4721,1133,242,4581,0,50,55,33,2454,2267,1719,1627,2716,2597,119,1616,981,2741,1414,1327,324,482,72,72064,4624,64,183700,0,1600,0.729530,0.000000,399
55133201800,Milwaukee,1536,436,193,1512,0,0,24,0,753,783,445,462,813,796,17,583,213,830,428,402,51,220,18,74063,1526,30,152900,0,524,0.215715,0.000000,400
55079170100,Milwaukee,2729,564,457,2536,0,19,157,0,1362,1367,881,827,1428,1412,16,1080,332,1428,761,667,100,384,61,51724,2708,67,123100,0,56,0.017202,0.000000,401
55079170200,Milwaukee,3510,614,779,3269,19,9,178,35,1686,1824,1031,1086,1865,1847,18,1276,571,1873,958,915,208,347,29,44336,3501,66,128100,19,29,0.006874,0.005413,402
55133201701,Milwaukee,4498,906,455,4410,7,0,67,7,2234,2264,1600,1537,2530,2450,80,1631,819,2560,1323,1237,243,513,58,64453,4422,34,154300,7,1298,0.610612,0.001556,403
55133201702,Milwaukee,9729,2622,686,9433,52,14,57,173,4899,4830,3230,3191,5377,5273,104,3215,2058,5448,2850,2598,603,1354,159,64558,9675,250,177800,52,124,0.041742,0.005345,404
55133202002,Milwaukee,3824,893,292,3701,14,21,38,38,1988,1836,1374,1265,2153,2106,47,1302,804,2171,1194,977,247,444,39,65804,3799,71,164400,14,294,0.129001,0.003661,405
55133201900,Milwaukee,4001,957,588,3816,6,86,63,30,1906,2095,1228,1228,2019,1982,37,1341,641,2066,1104,962,250,483,43,61500,3777,26,168900,6,0,0.000000,0.001500,406
55079170300,Milwaukee,2735,528,466,2637,0,19,67,12,1361,1374,887,854,1376,1345,31,932,413,1456,713,743,235,189,42,41315,2719,80,101600,0,9,0.002323,0.000000,407
55079170600,Milwaukee,3422,765,463,3091,46,20,196,46,1668,1754,1104,1090,1614,1595,19,1181,414,1640,874,766,257,196,18,32435,3422,483,96400,46,61,0.018290,0.013442,408
55079170700,Milwaukee,2899,748,209,2635,36,0,192,22,1419,1480,979,963,1476,1459,17,935,524,1513,837,676,270,241,38,51947,2894,224,100300,36,47,0.012552,0.012418,409
55079170400,Milwaukee,3417,813,458,3171,14,16,140,64,1723,1694,1097,1049,1841,1823,18,1364,459,1864,986,878,255,341,41,58269,3405,87,127100,14,0,0.000000,0.004097,410
55079170500,Milwaukee,2483,477,647,2198,52,24,175,34,1125,1358,669,690,1061,1061,0,719,342,1081,594,487,182,132,21,37703,2176,240,103100,52,806,0.474440,0.020942,411
55079150200,Milwaukee,8530,1668,498,6767,1308,203,199,36,5027,3503,3884,2480,3721,3579,142,2245,1334,3752,1944,1808,344,1115,160,76095,6643,23,162000,1308,314,0.134584,0.153341,412
55079160201,Milwaukee,8476,1619,727,7306,342,269,412,121,4165,4311,3068,3062,5224,5111,113,3383,1728,5291,2810,2481,446,1509,304,47554,8453,459,145400,342,3324,0.973236,0.040349,413
55133203900,Milwaukee,7705,1771,776,7383,38,26,227,23,3843,3862,2653,2505,4328,4213,115,2377,1836,4405,2375,2030,557,934,98,56701,7649,193,144500,38,0,0.000000,0.004932,414
55079160202,Milwaukee,6169,1532,668,5579,76,88,341,55,2995,3174,1924,2045,3279,3196,83,2265,931,3342,1668,1674,439,644,75,52203,6169,145,141800,76,3,0.000759,0.012320,415
55079160300,Milwaukee,7398,1915,489,6817,170,156,181,46,3702,3696,2492,2502,4147,4076,71,2748,1328,4189,2159,2030,517,942,100,73846,7378,59,140000,170,32,0.007703,0.022979,416
55079150400,Milwaukee,1092,212,136,1043,0,29,16,0,591,501,401,343,570,557,13,334,223,577,347,230,68,189,39,59583,1092,43,179300,0,1662,0.739302,0.000000,417
