FIPS,MSA,TOT_POP,POP_16,POP_65,WHITE_,BLACK_,ASIAN_,HISP_,MUTLI_RA,MALES,FEMALES,MALE1664,FEM1664,EMPL16,EMP_AWAY,EMP_HOME,EMP_29,EMP_30,EMP16_2,EMP_MALE,EMP_FEM,OCC_MAN,OCC_OFF1,OCC_INFO,HH_INC,POV_POP,POV_TOT,HSG_VAL,POLYID
26037010600,Lansing,2517,696,238,2455,0,6,41,10,1284,1233,817,766,1136,1059,77,515,544,1150,642,508,151,141,17,49000,2511,153,97700,0
26037010702,Lansing,2329,561,336,2245,0,4,71,3,1152,1177,715,717,1045,994,51,609,385,1069,585,484,232,103,10,39968,2321,173,90900,1
26037010701,Lansing,2115,490,230,2072,0,0,31,12,1084,1031,710,685,1084,1046,38,560,486,1111,624,487,172,136,7,53021,2111,70,124800,2
26037010500,Lansing,3497,974,372,3383,5,16,63,15,1806,1691,1119,1032,1666,1572,94,797,775,1682,944,738,217,238,35,54647,3491,126,128600,3
26037010901,Lansing,2790,624,487,2641,0,5,107,16,1422,1368,910,769,1270,1183,87,708,475,1283,741,542,149,199,21,52222,2418,124,118100,4
26037011001,Lansing,3490,898,457,3374,4,0,101,9,1652,1838,1032,1103,1586,1494,92,888,606,1614,882,732,283,135,14,42250,3387,225,96700,5
26037010800,Lansing,7471,1657,1022,7019,15,118,240,72,3617,3854,2340,2452,3731,3567,164,2397,1170,3816,1945,1871,441,631,41,42160,7429,492,99200,6
26037010400,Lansing,4598,1189,521,4461,5,9,91,26,2293,2305,1467,1421,2168,2078,90,1289,789,2210,1251,959,205,472,49,60137,4587,83,140400,7
26037011002,Lansing,3275,840,232,3169,37,0,20,37,1646,1629,1113,1090,1709,1626,83,889,737,1730,906,824,182,285,19,59375,3270,64,135100,8
26037010902,Lansing,4089,1022,411,3881,22,53,63,60,2105,1984,1359,1297,2126,2022,104,1444,578,2155,1155,1000,250,469,52,60117,4048,160,134700,9
26037010102,Lansing,2334,363,586,2147,0,6,119,21,1068,1266,636,749,1122,1069,53,885,184,1122,567,555,103,232,33,36929,2321,131,69900,10
26037011101,Lansing,3813,968,289,3510,5,48,135,104,1881,1932,1290,1266,1983,1884,99,1420,464,2009,1075,934,283,340,82,61023,3808,203,137000,11
26037010300,Lansing,4140,1008,279,3977,11,16,89,39,2114,2026,1450,1403,2167,2072,95,1772,300,2198,1208,990,208,572,69,67034,4127,92,147400,12
26037010101,Lansing,9619,2725,623,9070,98,0,236,95,4845,4774,3136,3135,5177,5044,133,4165,879,5229,2733,2496,289,1600,107,69792,9584,320,153800,13
26037010204,Lansing,1272,322,108,1154,0,34,45,26,622,650,399,443,676,651,25,546,105,676,363,313,67,170,46,54250,1272,53,119900,14
26037010201,Lansing,2109,297,360,1973,12,0,95,15,1095,1014,754,698,1097,1070,27,940,130,1116,644,472,52,248,24,46542,2109,57,106100,15
26037011102,Lansing,3725,908,293,3422,21,43,147,77,1808,1917,1219,1305,1993,1955,38,1441,514,2033,1055,978,192,426,14,50208,3679,137,93600,16
26037010203,Lansing,1570,364,134,1288,25,0,129,50,747,823,535,537,669,639,30,513,126,717,359,358,90,111,38,33421,1565,300,46600,17
26065005900,Lansing,5324,1327,473,5131,24,19,75,55,2639,2685,1785,1739,2632,2532,100,1501,1031,2686,1454,1232,296,495,60,49299,5291,360,123900,18
26065005700,Lansing,4717,1121,435,4501,70,32,54,41,2369,2348,1589,1572,2599,2493,106,1781,712,2646,1452,1194,123,793,50,73898,4690,93,163500,19
26045020700,Lansing,4277,1074,456,4112,0,7,109,40,2155,2122,1406,1341,1985,1869,116,847,1022,2035,1159,876,279,326,44,47878,4250,236,94500,20
26045020500,Lansing,3642,857,374,3446,8,11,92,26,1843,1799,1205,1206,1832,1785,47,1156,629,1851,1006,845,230,327,31,60096,3628,131,119600,21
26045020401,Lansing,6804,1522,888,6546,16,40,130,52,3220,3584,2077,2317,3429,3304,125,2571,733,3472,1804,1668,405,568,96,45047,6764,650,96800,22
26045020402,Lansing,2964,743,248,2836,41,0,63,19,1478,1486,989,984,1545,1499,46,1179,320,1553,827,726,88,375,41,59737,2944,120,128700,23
26065004700,Lansing,2683,457,470,2464,80,25,57,45,1203,1480,843,913,1442,1426,16,1120,306,1463,738,725,64,397,35,40250,2678,215,162200,24
26065004500,Lansing,3546,648,270,2734,282,219,154,92,1706,1840,1244,1384,1929,1914,15,1696,218,1987,966,1021,106,492,63,36392,3540,690,98400,25
26045020301,Lansing,7789,1343,1166,6700,449,179,268,147,3560,4229,2461,2819,4276,4165,111,3507,658,4316,2136,2180,230,1351,156,46108,7660,385,138200,26
26045020101,Lansing,2673,579,397,2265,209,49,48,85,1346,1327,830,867,1362,1323,39,1176,147,1374,733,641,139,387,49,79931,2673,25,173800,27
26065004600,Lansing,3719,822,459,3289,133,154,42,85,1784,1935,1176,1262,1924,1851,73,1544,307,1955,1034,921,87,719,64,80526,3710,105,182400,28
26065003301,Lansing,3215,921,295,1835,688,287,351,22,1618,1597,993,1006,1294,1276,18,1112,164,1319,676,643,195,156,20,29503,3204,718,76900,29
26065003200,Lansing,2339,701,226,1571,225,134,323,86,1226,1113,731,681,931,904,27,760,144,963,540,423,167,118,34,37039,2324,362,59400,30
26065003102,Lansing,3028,578,523,2486,237,64,137,97,1389,1639,820,1107,1580,1555,25,1336,219,1584,728,856,67,489,62,57768,3018,136,123700,31
26065003802,Lansing,4012,370,435,3223,223,335,108,65,1848,2164,1535,1672,2366,2335,31,2192,143,2391,1136,1255,98,705,102,32535,4007,1022,137500,32
26065004800,Lansing,7538,1618,694,6816,129,217,182,117,3455,4083,2398,2828,4161,4009,152,3250,759,4211,2031,2180,147,1157,164,50480,7532,539,130300,33
26065000100,Lansing,2183,559,291,1518,200,0,345,103,1036,1147,672,661,894,876,18,741,135,931,498,433,96,87,0,32863,2176,366,51300,34
26065003302,Lansing,2465,506,396,1847,323,130,116,49,1158,1307,735,828,1246,1183,63,1026,157,1282,634,648,87,397,85,55977,2448,105,103500,35
26065000200,Lansing,1394,438,67,689,256,10,394,23,649,745,390,499,593,572,21,512,60,598,297,301,64,101,17,28681,1394,422,65600,36
26065003801,Lansing,4197,799,389,3120,494,198,148,193,1952,2245,1410,1599,2344,2273,71,2061,212,2436,1176,1260,36,631,81,50017,4197,558,142000,37
26065000900,Lansing,1853,311,201,1384,136,91,207,11,924,929,658,683,971,947,24,793,154,1005,484,521,51,270,21,39704,1844,235,67200,38
26065000300,Lansing,2455,697,143,1291,536,7,420,147,1179,1276,779,836,1008,977,31,774,203,1033,537,496,83,128,7,25609,2451,685,48600,39
26065003901,Lansing,2189,329,538,1786,179,84,59,81,946,1243,583,739,1039,990,49,914,76,1053,527,526,4,391,20,73036,2078,132,228000,40
26065003400,Lansing,2494,519,481,2065,244,20,151,14,1188,1306,691,803,1220,1185,35,1024,161,1238,570,668,128,277,19,45900,2449,138,97000,41
26045020103,Lansing,4321,915,593,3433,393,101,205,163,2025,2296,1340,1473,2133,2094,39,1776,318,2163,1120,1043,127,512,74,51111,4183,350,132000,42
26065000800,Lansing,3661,1172,221,1718,653,51,967,175,1919,1742,1172,1096,1361,1340,21,1092,248,1397,751,646,176,107,15,30977,3617,811,42700,43
26065003902,Lansing,4082,539,650,3566,159,147,98,106,1922,2160,1433,1460,2094,2018,76,1833,185,2153,1145,1008,51,642,64,33859,3912,981,146000,44
26065000700,Lansing,2891,744,122,1504,658,328,319,72,1499,1392,1089,936,1282,1217,65,970,247,1303,762,541,123,186,17,27525,2873,955,57500,45
26065000500,Lansing,1731,492,158,803,661,5,211,36,959,772,587,494,684,654,30,554,100,709,349,360,110,62,7,26344,1716,526,50500,46
26065003101,Lansing,1430,127,221,1112,88,91,96,43,692,738,552,530,908,880,28,800,80,914,444,470,59,275,22,37470,1430,133,103600,47
26065000400,Lansing,3064,750,262,1811,839,0,261,128,1552,1512,1020,1032,1582,1535,47,1314,221,1632,851,781,128,420,59,46615,3044,349,80500,48
26065004000,Lansing,4425,540,483,3983,174,88,98,38,2035,2390,1561,1841,2391,2314,77,2031,283,2429,1108,1321,54,716,98,38750,3734,675,157100,49
26065004100,Lansing,4614,66,127,4247,33,94,79,88,2254,2360,2186,2235,2196,2135,61,1984,151,2305,1090,1215,17,419,67,17470,4079,2790,123600,50
26065001000,Lansing,2222,399,204,1833,169,43,109,32,1053,1169,786,833,1276,1243,33,1099,144,1311,633,678,50,293,49,36451,2183,353,67200,51
26065003500,Lansing,2985,668,245,2246,304,64,307,64,1456,1529,982,1090,1587,1577,10,1410,167,1611,810,801,148,262,34,38688,2923,228,60300,52
26045020104,Lansing,3698,816,350,2897,236,140,206,197,1774,1924,1172,1360,2103,2009,94,1854,155,2161,1043,1118,208,467,85,52099,3698,96,101700,53
26045020102,Lansing,3219,479,439,2267,428,191,202,91,1497,1722,1130,1171,1888,1864,24,1710,154,1899,1000,899,107,548,130,33157,3212,349,143800,54
26065006500,Lansing,3649,768,272,2533,363,76,407,190,1861,1788,1308,1301,1901,1830,71,1588,242,1963,982,981,103,413,84,31467,3576,618,64900,55
26065000600,Lansing,1808,295,114,909,528,29,239,103,908,900,716,683,902,850,52,705,145,933,511,422,46,189,52,27204,1760,480,79000,56
26065001300,Lansing,1397,390,141,607,275,110,264,141,649,748,444,422,450,413,37,279,134,462,257,205,79,30,0,14069,1394,489,33800,57
26065004301,Lansing,5251,545,392,4673,62,234,165,44,2720,2531,2336,1978,3113,3046,67,2604,442,3288,1732,1556,57,808,160,38606,5238,1678,119300,58
26065005002,Lansing,4107,1048,432,3665,89,164,102,75,1978,2129,1291,1336,1984,1840,144,1458,382,2007,1091,916,59,766,66,90376,3905,146,202300,59
26065001400,Lansing,44,0,0,34,0,0,0,0,34,10,34,10,26,26,0,26,0,36,26,10,0,16,8,13500,44,8,0,60
26065004200,Lansing,5440,0,0,4282,540,328,188,59,2380,3060,2380,3060,2366,2279,87,2042,237,2508,1075,1433,42,324,66,13750,29,24,0,61
26065001500,Lansing,2097,596,324,584,1285,20,156,40,984,1113,561,616,663,629,34,567,62,685,283,402,84,101,49,14523,2091,769,61100,62
26065004901,Lansing,6400,1332,688,5354,319,437,197,67,3082,3318,2111,2269,3536,3405,131,2875,530,3590,1826,1764,57,1356,215,60053,6296,556,154400,63
26065001600,Lansing,1221,175,187,330,779,0,53,56,667,554,462,397,661,644,17,536,108,661,374,287,61,145,7,50583,1221,212,89800,64
26065004404,Lansing,3716,14,0,3213,303,54,88,30,1790,1926,1790,1912,1252,1208,44,1064,144,1330,516,814,19,191,52,37321,38,0,0,65
26065004302,Lansing,3116,26,91,2506,109,265,144,42,1533,1583,1521,1478,1574,1557,17,1399,158,1730,831,899,66,279,55,14426,2922,2134,0,66
26065001900,Lansing,634,92,62,331,163,5,65,64,354,280,284,196,283,283,0,234,49,292,183,109,10,34,0,11940,634,243,55000,67
26065004403,Lansing,2095,345,62,1056,211,681,92,49,1074,1021,865,823,1115,1104,11,1060,44,1147,615,532,40,356,54,21667,2095,628,115300,68
26065001200,Lansing,2501,635,198,1416,521,38,349,170,1362,1139,847,821,1086,1047,39,919,128,1126,638,488,89,124,6,27159,2501,721,44100,69
26065004405,Lansing,3537,0,0,2674,308,436,65,32,1689,1848,1689,1848,1714,1655,59,1495,160,1812,749,1063,11,232,44,6250,19,19,0,70
26065002100,Lansing,2444,697,147,1236,666,31,378,94,1191,1253,761,839,1126,1078,48,887,191,1155,583,572,167,106,27,30601,2412,724,42800,71
26065004902,Lansing,3673,530,363,2959,147,365,89,67,1759,1914,1311,1469,2039,1964,75,1665,299,2095,1070,1025,42,700,95,46250,3673,699,180000,72
26045020201,Lansing,2703,535,356,2111,499,0,50,36,1252,1451,819,993,1416,1384,32,1224,160,1446,666,780,66,443,94,55250,2699,109,123600,73
26065002901,Lansing,3109,618,403,2253,593,31,183,38,1451,1658,938,1150,1687,1653,34,1457,196,1695,782,913,90,386,86,45339,2998,310,97100,74
26065002000,Lansing,3819,1084,192,2290,642,134,479,196,2014,1805,1311,1232,1573,1533,40,1247,286,1620,879,741,186,141,19,26171,3784,931,40800,75
26065001701,Lansing,922,136,233,810,77,13,15,7,479,443,293,260,413,408,5,368,40,425,256,169,12,182,6,60063,922,18,136900,76
26045020202,Lansing,4346,1225,338,1874,1774,173,292,220,2077,2269,1265,1518,1895,1824,71,1545,279,1938,930,1008,228,284,42,39278,4339,513,83400,77
26065004402,Lansing,2168,359,0,281,652,992,89,149,1084,1084,897,912,1032,1032,0,913,119,1070,575,495,26,206,57,10399,2166,1115,0,78
26065002400,Lansing,3249,792,310,2380,419,4,323,93,1443,1806,970,1177,1682,1632,50,1403,229,1734,809,925,143,258,41,40811,3233,433,69700,79
26065002200,Lansing,1595,314,224,1308,73,0,138,68,704,891,478,579,839,828,11,734,94,856,423,433,47,234,32,46058,1585,107,85400,80
26065002500,Lansing,2522,662,378,2054,262,5,22,160,1054,1468,636,846,1228,1212,16,1053,159,1249,570,679,53,360,15,42426,2522,122,80100,81
26065005800,Lansing,5199,1351,590,5023,0,19,109,37,2511,2688,1568,1690,2608,2536,72,1802,734,2641,1369,1272,207,623,38,50672,5193,314,124500,82
26065001702,Lansing,3741,861,572,2078,1236,54,243,85,1722,2019,1052,1256,1908,1840,68,1541,299,1950,902,1048,147,531,43,54177,3733,147,108500,83
26065002600,Lansing,2036,382,273,1602,59,0,262,113,955,1081,654,727,1137,1102,35,958,144,1147,519,628,96,213,39,32880,2027,238,64000,84
26065002300,Lansing,3375,723,371,2916,170,16,217,23,1566,1809,1087,1194,1867,1844,23,1602,242,1910,897,1013,118,416,63,40000,3372,251,77200,85
26065005001,Lansing,5934,1464,319,4707,265,758,48,156,2865,3069,1994,2157,3227,3138,89,2712,426,3256,1713,1543,70,1248,145,70082,5921,374,182400,86
26065003700,Lansing,5733,1416,714,3619,1115,13,537,323,2755,2978,1749,1854,2428,2380,48,2007,373,2476,1234,1242,301,302,22,28367,5613,1077,72500,87
26065003602,Lansing,3781,1211,286,1667,1177,324,412,196,1681,2100,1001,1283,1496,1477,19,1271,206,1525,736,789,163,117,0,34248,3743,661,65900,88
26065002800,Lansing,2601,532,388,2105,145,18,224,79,1223,1378,822,859,1302,1270,32,1042,228,1311,663,648,93,170,53,38168,2596,397,73000,89
26065003601,Lansing,3800,1087,341,1257,1869,163,328,153,1805,1995,1063,1309,1641,1619,22,1228,391,1678,850,828,207,243,29,43211,3752,459,69700,90
26065002700,Lansing,3232,763,395,2502,376,56,225,73,1490,1742,966,1108,1689,1666,23,1452,214,1720,834,886,174,249,59,43203,3207,225,65600,91
26045020302,Lansing,4241,970,408,4036,94,20,49,42,2100,2141,1416,1447,2392,2298,94,1959,339,2400,1230,1170,178,657,111,72163,4241,90,140000,92
26065002902,Lansing,3396,346,53,2327,444,296,199,73,1784,1612,1589,1408,2381,2373,8,2166,207,2441,1331,1110,99,683,187,29183,3396,806,60500,93
26045020600,Lansing,6658,1649,578,6345,37,19,177,63,3284,3374,2196,2235,3369,3233,136,2241,992,3411,1774,1637,455,485,83,50217,6616,276,109100,94
26045021400,Lansing,8839,1934,1145,7386,630,176,391,189,4315,4524,2857,2903,4502,4375,127,3725,650,4555,2323,2232,460,890,117,51124,8644,496,111000,95
26065005100,Lansing,3680,1123,240,1661,1379,52,382,162,1695,1985,1021,1296,1670,1665,5,1249,416,1716,791,925,246,228,71,37987,3646,594,70900,96
26065005201,Lansing,4902,1302,329,2995,1060,236,390,195,2182,2720,1337,1934,2296,2244,52,1804,440,2376,1022,1354,237,370,34,31849,4873,729,68800,97
26065005303,Lansing,4782,1022,671,3557,724,38,348,88,2217,2565,1466,1623,2314,2228,86,1762,466,2387,1224,1163,191,550,84,35446,4739,460,85900,98
26065005600,Lansing,3501,654,390,3126,192,0,116,43,1977,1524,1457,1000,1581,1485,96,1197,288,1623,906,717,95,443,47,64680,3112,162,150100,99
26065005304,Lansing,3462,768,378,2181,698,56,273,249,1649,1813,1073,1243,1718,1684,34,1397,287,1721,865,856,207,258,41,31197,3258,581,81000,100
26065005302,Lansing,5630,1369,465,4784,302,58,237,186,2702,2928,1822,1974,3006,2896,110,2354,542,3062,1569,1493,208,744,166,46916,5630,414,106100,101
26065005202,Lansing,3321,1019,210,2931,105,35,175,75,1619,1702,1015,1077,1598,1547,51,1205,342,1630,855,775,44,477,53,63708,3321,141,132800,102
26065005501,Lansing,4684,1038,748,4321,55,65,33,112,2171,2513,1415,1483,2327,2233,94,1968,265,2361,1221,1140,160,574,84,53802,4596,179,125500,103
26065005400,Lansing,7374,1768,711,6731,96,71,286,127,3560,3814,2352,2543,3888,3757,131,3057,700,3985,1993,1992,369,756,111,42789,7367,548,96500,104
26065005502,Lansing,4559,1278,284,4093,176,35,181,69,2185,2374,1433,1564,2385,2326,59,1832,494,2418,1197,1221,206,493,75,52566,4538,196,112700,105
26065006000,Lansing,6591,1603,652,6319,11,21,105,86,3317,3274,2244,2092,3116,2997,119,1273,1724,3189,1813,1376,533,435,50,49167,6530,483,127800,106
26045021200,Lansing,5972,1505,486,5739,17,11,108,73,2996,2976,2022,1959,3217,3128,89,1931,1197,3262,1815,1447,440,605,63,57341,5922,182,125000,107
26045021000,Lansing,7773,1796,844,7399,47,31,191,94,3890,3883,2614,2519,3945,3779,166,2481,1298,4004,2201,1803,552,690,62,55095,7418,303,118800,108
26045020800,Lansing,4886,1136,562,4766,4,8,60,36,2422,2464,1585,1603,2365,2293,72,1261,1032,2420,1318,1102,473,283,23,45245,4860,283,96500,109
26065006300,Lansing,7326,1581,1005,6911,16,124,199,71,3481,3845,2276,2464,3930,3767,163,2994,773,4008,2026,1982,314,726,105,43312,7282,272,107200,110
26065006400,Lansing,6276,1632,470,5966,41,10,191,57,3173,3103,2107,2067,3230,3071,159,1876,1195,3275,1775,1500,340,562,78,58534,6224,389,121300,111
26045020900,Lansing,7520,1901,957,7053,7,33,246,140,3646,3874,2315,2347,3654,3564,90,2539,1025,3720,2000,1720,580,506,66,37161,7446,754,82300,112
26045021300,Lansing,6132,1605,668,5859,10,0,186,44,2924,3208,1858,2001,2866,2795,71,1582,1213,2888,1495,1393,502,413,25,41479,6058,321,91100,113
26065006200,Lansing,5063,1176,419,4842,23,12,84,54,2544,2519,1750,1718,2585,2502,83,1615,887,2663,1423,1240,233,503,54,56532,5049,150,126900,114
26045021100,Lansing,5198,1185,414,4793,203,32,90,47,2634,2564,1838,1761,2530,2432,98,1469,963,2574,1383,1191,371,421,35,45833,4630,279,102600,115
26065006100,Lansing,4371,1071,403,4260,2,12,42,51,2156,2215,1448,1449,2156,2086,70,1279,807,2192,1137,1055,363,352,27,49196,4362,308,101100,116
